Images may be subject to copyright.	Las imágenes pueden estar protegidas por derechos de autor.
Try more general keywords.	Intenta usar palabras más generales.
Make sure all words are spelled correctly.	Comprueba que todas las palabras están escritas correctamente.
Click for video information	Haz clic para ver la información en vídeo
Click for product information	Haz clic para ver la información sobre el producto
Check website for latest pricing and availability.	Accede al sitio web para consultar la disponibilidad y el precio más reciente.
Tap and hold to copy link	Mantén pulsado el enlace para copiarlo
Tap to copy link	Toca para copiar el enlace
Looks like this collection is empty	Parece que esta colección está vacía
Bring back cards you removed	Recuperar las tarjetas que has quitado
Stop seeing certain cards	Dejar de ver determinadas tarjetas
Anyone with the link can see this collection	Cualquier usuario que tenga el enlace puede ver esta colección.
Only you can see this collection	Solo tú puedes ver esta colección.
Tap a match to see player stats	Toca un partido para ver estadísticas de los jugadores
Failed to change your settings. Try again later.	No se ha podido cambiar tu configuración. Inténtalo de nuevo más tarde.
To get alerts, notifications should be turned on in both Google app and device settings.	Para recibirlas, las notificaciones deben estar activadas en la aplicación de Google y en la configuración del dispositivo.
Keep your Google Account secure: Get real-time security alerts directly on your device.	Protege tu cuenta de Google: recibe directamente en tu dispositivo alertas de seguridad en tiempo real.
Unfollowing will remove this collection from your list of collections.	Si dejas de seguir esta colección, se quitará de tu lista de colecciones.
Full time · See stats, news, and more	Fin del partido · Consulta estadísticas, noticias y mucho más
Send us your video content	Envíanos tu contenido de vídeo.
Harness the power of GIFs to reach an engaged audience of 350M+ people.	Aprovecha el potencial de los GIF para llegar a una audiencia participativa de más de 350 millones de personas.
Only you can see your personal results.	Solo tú puedes ver el contenido personal.
To include an app in search results, tap it again.	Para incluir una aplicación en los resultados de búsqueda, tócala de nuevo.
How your app info stays private	Por qué la información de las aplicaciones sigue siendo privada
To remove an app from search results, tap it.	Si quieres quitar una aplicación de los resultados de búsqueda, tócala.
When you search in apps on your phone, you can see:	Cuando haces búsquedas en las aplicaciones de tu teléfono, puedes ver lo siguiente:
In the search box, type what you’re looking for.	En el cuadro de búsqueda, escribe tu consulta.
Tap the language you want to view the translation.	Toca el idioma en el que quieras ver la traducción.
This field is required.	Este campo es obligatorio.
Sign in to save jobs	Para guardar ofertas de trabajo, inicia sesión
Only you and your parent can see this data. Google protects your privacy and security.	Solamente tú y tus padres podéis ver estos datos. Google protege tu privacidad y seguridad.
Only you can see this data. Google protects your privacy and security.	Solo tú puedes ver estos datos. Google protege tu privacidad y seguridad.
Search business class flights	Buscar vuelos en clase business
Send feedback to Google	Envía comentarios a Google
Related to your search	Relacionados con tus búsquedas
Unable to share collection. Please check your popup blocker.	No se ha podido compartir la colección. Comprueba el estado de tu bloqueador de ventanas emergentes.
Sao Tome and Principe	Santo Tomé y Príncipe
Saint Kitts and Nevis	San Cristóbal y Nieves
Saint Pierre and Miquelon	San Pedro y Miquelón
Bonaire, Sint Eustatius, and Saba	Bonaire, San Eustaquio y Saba
My SafeSearch setting keeps turning off	La función Búsqueda Segura se desactiva sola
If you allow cookies, SafeSearch should stay on.	Si permites las cookies, Búsqueda Segura debería permanecer activada.
Block explicit results on Google using SafeSearch	Bloquear resultados con contenido explícito en Google mediante Búsqueda Segura
Find widgets on Google Play	Buscar widgets en Google Play
Notices about Filtered Results	Avisos sobre resultados filtrados
A label showing the percentage change in price.	Etiqueta en la que se muestra el porcentaje de cambio en el precio.
This reminder has been deleted. Please refresh the browser to view the updated list.	Se ha eliminado este recordatorio. Actualiza el navegador para ver la lista modificada.
From your Gmail reservation	De tu reserva de Gmail
You can delete all of this data or change this setting.	Puedes eliminar todos estos datos o cambiar el ajuste.
Select one from the following list of service providers	Selecciona una opción de la siguiente lista de proveedores de servicios
Google Search Page Header	Encabezado de la página de la Búsqueda de Google
Search for a company or symbol	Buscar una empresa o un símbolo
Keep track of your watchlist and watch how it performs	Controla tu lista de seguimiento y observa cómo evoluciona
Unable to share collection	No se puede compartir la colección
Stories must be a least four pages	Las noticias deben tener al menos cuatro páginas
Final · See stats, news, and more	Finalizado · Consulta estadísticas, noticias y mucho más
Get it on Google Play	Descargar de Google Play
Data shared for research	Datos compartidos para la investigación
See and delete your preferences about News.	Consulta y elimina tus preferencias de Noticias.
Manage music you’ve identified with the Sound Search widget.	Gestiona la música que hayas identificado con el widget Sound Search.
View YouTube Community posts	Ver publicaciones de la comunidad de YouTube
Manage Google Play Sound Search History	Gestionar el historial de Sound Search de Google Play
Google Play Sound Search History	Historial de Sound Search de Google Play
Comments on YouTube Community posts	Comentarios en publicaciones de la comunidad de YouTube
Comments on YouTube videos	Comentarios en vídeos de YouTube
See and delete your answers to survey questions from Google.	Consulta y elimina tus respuestas a encuestas de Google.
Teams and leagues you follow	Equipos y ligas que sigues
A performance comparison of financial entities, composed of table and chart.	Una comparación del rendimiento de entidades financieras que incluye una tabla y un gráfico.
A table showing the prices at the selected time point in the chart.	Una tabla que muestra los precios en el periodo seleccionado en el gráfico.
Your answers will improve Search for other people. Learn more.	Tus respuestas ayudan a mejorar la Búsqueda para todos los usuarios. Más información
You suggested this change. Edit?	Esta es tu sugerencia. ¿Quieres cambiarla?
Improve the language on this page	Mejorar los textos en este idioma
Manage your Google Tag Manager container versions	Administrar las versiones de tus contenedores de Google Tag Manager
View monetary and non-monetary YouTube Analytics reports for your YouTube content	Ver informes económicos y no económicos de YouTube Analytics de tu contenido de YouTube
View YouTube Analytics reports for your YouTube content	Permite ver informes de YouTube Analytics sobre su contenido de YouTube.
View your Google Tag Manager container and its subcomponents	Consultar tu contenedor de Google Tag Manager y sus subcomponentes
Manage user permissions of your Google Tag Manager account and container	Administrar los permisos de los usuarios de tu cuenta y contenedor de Google Tag Manager
Publish your Google Tag Manager container versions	Publicar las versiones de tu contenedor de Google Tag Manager
View and manage creatives and campaigns for DoubleClick Studio	Permite visualizar y administrar creatividades y campañas de DoubleClick Studio.
Delete your Google Tag Manager containers	Eliminar tus contenedores de Google Tag Manager
View creatives and campaigns for DoubleClick Studio	Permite visualizar creatividades y campañas de DoubleClick Studio.
View and manage your Google Tag Manager accounts	Consultar y administrar tus cuentas de Google Tag Manager
Tap a match to see scores, stats, and more	Toca un partido para ver resultados, estadísticas y mucho más
Type a name, phone, or email	Nombre, teléfono o correo
This site may be hacked.	Este sitio web puede haber sido pirateado.
Update your featured image on Search	Actualiza tu imagen destacada en la Búsqueda
Saved items will be added to this collection	Los elementos guardados se añadirán a esta colección
Open in Google Podcasts	Abrir en Podcasts de Google
Your Site on Google	Tu sitio web en Google
Your activity, while you were signed in to Google.	Tu actividad con la sesión iniciada en tu cuenta de Google.
Add a Finance shortcut to your Home screen	Añade un acceso directo de Finance a tu pantalla de inicio
How your saved activity is used	Cómo se utiliza tu actividad guardada
To let Google save this information:	Para permitir que Google guarde esta información:
Your Chrome browsing history	Tu historial de navegación de Chrome
Information on your device like recent apps or contact names you searched for	Información sobre tu dispositivo, como aplicaciones recientes o nombres de contacto que has buscado
See or delete your search activity	Ver o eliminar la actividad de búsqueda
*Not all languages are supported.	* No todos los idiomas están disponibles.
Therefore, these pages are no longer accessible from Google search.	Por lo tanto, ya no es posible acceder a ellas desde una búsqueda en Google.
Watch the most memorable moments of the tournament	Mira los momentos más memorables del torneo
Add a missing place to Google Maps.	Añadir un sitio que falta a Google Maps
Lifetime on most items	Permanente para la mayoría de los artículos
Tin Tan’s 103rd Birthday	103.º aniversario del nacimiento de Tin Tan
Professor Dorothy Hill’s 111th Birthday	111.º aniversario del nacimiento de la profesora Dorothy Hill
Josefa Llanes Escoda’s 120th Birthday	120.º aniversario del nacimiento de Josefa Llanes Escoda
Junko Tabei’s 79th Birthday	79.º aniversario del nacimiento de Junko Tabei
Joanna Baillie’s 256th Birthday	256.º aniversario del nacimiento de Joanna Baillie
Fatima Surayya Bajia’s 88th Birthday	88.º aniversario del nacimiento de Fatima Surayya Bajia
your One Drive account	tu cuenta de OneDrive
Caio Fernando Abreu’s 70th Birthday	70.º aniversario del nacimiento de Caio Fernando Abreu
Initiated a bulk download from Drive	Se ha iniciado una descarga en bloque en Drive
We are sorry, the service is currently unavailable. Please verify your internet connection and try again.	El servicio no está disponible en estos momentos. Comprueba tu conexión a Internet e inténtalo de nuevo.
Sent to Google Home	Se ha enviado a Google Home
Send to Google Home	Enviar a Google Home
Compare to another index	Comparar con otro índice
Compare to another stock	Comparar con otra acción
Next to each stock you want to follow, tap or click the box.	Toca o haz clic en las casillas de las acciones que quieras seguir.
Voice search results come in the same language as your voice search.	Los resultados de la búsqueda por voz se obtienen en el mismo idioma que utilizas para la búsqueda por voz.
Pick the language for your search results.	Puedes elegir el idioma en el que quieres ver tus resultados de búsqueda.
At the top left, tap your photo.	En la parte superior izquierda, toca tu foto.
Tap a category to see options and make changes.	Tocar una categoría para ver las opciones correspondientes y realizar cambios.
At the top left, tap your photo.	En la parte superior izquierda, toca tu foto.
You can turn these video previews on or off, and change when they play.	Puedes activar o desactivar estas vistas previas de vídeos y cambiar cuándo se reproducen.
Videos in your feed could start playing automatically without sound.	Los vídeos de tu tablón pueden empezar a reproducirse automáticamente sin sonido.
Videos could start playing automatically without sound.	Los vídeos pueden empezar a reproducirse automáticamente sin sonido.
Press the Home button.	Pulsa el botón de inicio.
Replace all existing events	Sustituir todos los eventos
Import from Google Sheets	Importar de Hojas de cálculo de Google
This image may be subject to copyright.	Esta imagen puede estar sujeta a derechos de autor.
Sergey Prokudin-Gorsky’s 155th Birthday	155.º aniversario del nacimiento de Sergey Prokudin-Gorsky
Viola Desmond’s 104th Birthday	104.º aniversario del nacimiento de Viola Desmond
Mehdi Hassan’s 91st Birthday	91.º aniversario del nacimiento de Mehdi Hassan
Leonard Bernstein’s 100th Birthday	100.º aniversario del nacimiento de Leonard Bernstein
José Emilio Pacheco’s 79th Birthday	79.º aniversario del nacimiento de José Emilio Pacheco
Prasanta Chandra Mahalanobis’ 125th Birthday	125.º aniversario del nacimiento de Prasanta Chandra Mahalanobis
Meena Kumari’s 85th Birthday	85.º aniversario del nacimiento de Meena Kumari
Prayoon Yommium’s 85th Birthday	85.º aniversario del nacimiento de Prayoon Yommium
Pumpuang Duangjan’s 57th Birthday	57.º aniversario del nacimiento de Pumpuang Duangjan
Dilip Sardesai’s 78th Birthday	78.º aniversario del nacimiento de Dilip Sardesai
Gerda Taro’s 108th Birthday	108.º aniversario del nacimiento de Gerda Taro
Gauhar Jaan’s 145th Birthday	145.º aniversario del nacimiento de Gauhar Jaan
Reload as optimized page	Volver a cargar como página optimizada
Carmen Conde’s 111th Birthday	111.º aniversario del nacimiento de Carmen Conde
Sort by personal match	Ordenar por coincidencia personal
Hourly, humidity, wind and more	Hora, humedad, viento y más
See stocks you’re following	Ver las acciones que sigues
Tap an upcoming reminder.	Toca un recordatorio próximo.
Note that these changes may not appear on all Google Searches.	Recuerda que es posible que estos cambios no aparezcan en todas las búsquedas de Google.
The end date must be after the start date.	La fecha de finalización debe ser posterior a la fecha de inicio.
Replace all existing events?	¿Quieres sustituir todos los eventos?
The title must have at least one letter or numeric character.	El título debe tener al menos una letra o un número.
Paste the link to your Google spreadsheet here and your events will be imported.	Pega aquí el enlace a tu hoja de cálculo de Google y se importarán tus eventos.
This event will be permanently deleted and cannot be recovered.	Este evento se eliminará permanentemente y no se podrá recuperar.
is missing one or more required field	no tiene uno o varios de los campos requeridos
has an invalid start time or date	tiene una fecha u hora de inicio no válida
has an invalid end time or date	tiene una fecha u hora de finalización no válida
This search is trending in your area.	Esta búsqueda se está volviendo popular en tu zona.
Start repeating Morse symbol after	Empezar a repetir el símbolo en morse después de
Talal Maddah’s 78th Birthday	78.º aniversario del nacimiento de Talal Maddah
Sergey Prokudin-Gorsky’s 155th birthday	155.º aniversario del nacimiento de Sergey Prokudin-Gorsky
Prayoon Yommium’s 85th birthday	85.º aniversario del nacimiento de Prayoon Yomyiam
Pumpuang Duangjan’s 57th birthday	57.º aniversario del nacimiento de Pumpuang Duangjan
Marga Faulstich’s 103rd Birthday	103.º aniversario del nacimiento de Marga Faulstich
Meena Kumari’s 85th birthday	85.º aniversario del nacimiento de Meena Kumari
Leonard Bernstein’s 100th birthday	100.º aniversario del nacimiento de Leonard Bernstein
Gerda Taro’s 108th birthday	108.º aniversario del nacimiento de Gerda Taro
Dilip Sardesai’s 78th birthday	78.º aniversario del nacimiento de Dilip Sardesai
Celebrating Johann Sebastian Bach	Homenaje a Johann Sebastian Bach
Carmen Conde’s 111th birthday	111.º aniversario del nacimiento de Carmen Conde
85th Anniversary of Biskupin settlement discovery	85.º aniversario del descubrimiento del asentamiento de Biskupin
197th Anniversary of Zugspitze first ascent	197.º aniversario de la primera ascensión del Zugspitze
People who liked this also like	A los usuarios a los que les gusta esto también les gusta
Customize cards in your feed	Personalizar el Tablón de la aplicación de Google
From the top left, tap your profile picture.	En la esquina superior izquierda, toca tu foto de perfil.
Choose the day or date range.	Elige el día o el periodo que quieras eliminar.
You may be asked to sign in to your Google Account.	Puede que tengas que iniciar sesión con tu cuenta de Google.
What info is saved in your feed activity	¿Qué información se guarda en la actividad de tu tablón?
Which cards you view, swipe away, or hide	Las tarjetas que consultas, deslizas u ocultas
The cards and results that appeared in your feed	Las tarjetas y los resultados que se muestran en tu tablón
The device you use to access your feed	El dispositivo que utilizas para acceder a tu tablón
You can get more helpful cards and search results from your feed activity.	A partir de la actividad de tu tablón, Google puede mostrarte tarjetas y resultados de búsqueda más útiles.
Would you like to leave feedback about your call?	¿Quieres hacernos llegar tus comentarios sobre la llamada?
Featured snippet from the web	Fragmento destacado de la Web
Video featured snippet from the web	Fragmento destacado de vídeo de la Web
Unable to hide this card. Please try again later.	No se ha podido ocultar esta tarjeta. Vuelve a intentarlo más tarde.
Try an optimized page.	Prueba con una página optimizada.
Try again in a few minutes.	Vuelve a intentarlo en unos minutos.
No theaters near the selected location.	No hay ningún cine cerca de la ubicación seleccionada.
Create or delete a reminder	Crear o eliminar un recordatorio
sergej milinkovic-savic news	noticias sobre sergej milinkovic-savic
hannes thór halldórsson news	noticias sobre hannes thór halldórsson
Changes in network conditions	Cambios en el estado de la red
Results can vary for many reasons, like:	Los resultados pueden variar por muchas razones, por ejemplo:
The best internet connections have high download and upload speeds but low latency.	Con las mejores conexiones a Internet, las velocidades de subida y de descarga son altas y la latencia es baja.
Why your test results could vary	Por qué pueden variar los resultados de la prueba
There are a few ways you can create a reminder in the Google app:	Hay varias formas de crear recordatorios en dicha aplicación:
Provide the following to publish this event	Proporciona la siguiente información para publicar este evento
Say "Ok Google" to start a voice search.	Di "Ok Google" para iniciar una búsqueda por voz.
Search without lifting a finger. When you say "Ok Google," Chrome will search for what you say next.	Busca sin mover un dedo. Di "Ok Google" y Chrome buscará lo que digas a continuación.
Listening for "Ok Google"	Esperando escuchar "Ok Google"
Improve voice search by sending the sound of "Ok Google," and a few seconds before, to Google.	Mejora la búsqueda por voz enviando el sonido de "Ok Google" y el de unos segundos antes de decirlo a Google.
To get started, set up "Ok Google" on your device.	Para empezar, configura "Ok Google" en tu dispositivo.
To change these times:	Para cambiar este tiempo:
You can pause, move forward or back, change speed, and shorten silences.	Puedes pausarlo, avanzar o retroceder, cambiar la velocidad y acortar los silencios.
By default, Google Podcasts removes downloaded episodes:	De manera predeterminada, Podcasts de Google borra los episodios descargados:
Change when downloads are removed	Cambiar cuándo se quitan las descargas
Find an episode of a subscribed podcast	Buscar episodios de podcasts a los que te has suscrito
Play an episode of a podcast	Reproducir episodios de podcasts
On your Android phone or tablet, you can:	En tu teléfono o tablet Android, puedes:
You can see your subscriptions at the top of Google Podcasts.	Puedes ver tus suscripciones en la parte superior de la aplicación Podcasts de Google.
Listen to podcasts on Google Home	Escuchar podcasts en Google Home
Cast podcasts to Chromecast Audio	Enviar podcasts a Chromecast Audio
Listen to podcasts with Google Podcasts	Escuchar podcasts con Podcasts de Google
Turn off ads from this advertiser	Desactivar los anuncios de este anunciante
Add your favorite stocks for quick access and to stay in know with the latest financial news.	Añade tus acciones favoritas para poder acceder a ellas rápidamente y estar al tanto de las últimas noticias financieras.
Recommendation , featured, storage, shows, episodes, playback speed, offline listening, trim silence	Recomendación, destacado, almacenamiento, programas, episodios, velocidad de reproducción, escuchar sin conexión, recortar silencio
Subscribe to podcasts and get the latest episodes	Suscríbete a podcasts y recibe los episodios más recientes.
You can listen and download any podcast you’ve heard of anywhere, anytime for free.	Puedes escuchar y descargar cualquier podcast del que hayas oído hablar en cualquier lugar y momento gratuitamente.
Trim silence to cut silences from episodes so you finish them faster, saving hours	Recorta los silencios de los episodios para terminar de escucharlos antes y ahorrar tiempo.
Listen to podcasts at your preferred playback speed with the variable speed feature.	Escucha podcasts a la velocidad que prefieras con la función de velocidad variable.
Safely manage your podcast subscriptions with cloud storage.	Gestiona de forma segura tus suscripciones a podcasts con el almacenamiento en la nube.
Listen on all your devices	Escucha podcasts en todos tus dispositivos
Listen to the same podcast on multiple devices without losing your place.	Escucha el mismo podcast en varios dispositivos sin que se pierda la posición por donde ibas.
Pause on your phone and pick up where you left off on your Google Home.	Pausa la reproducción en tu teléfono y continúa en tu Google Home desde el mismo punto.
Receive the latest episodes of your favorite podcasts directly on your phone.	Recibe los últimos episodios de tus podcasts favoritos directamente en tu teléfono.
Google Podcasts is a new way for Android users to discover and listen to any podcast.	Podcasts de Google es una nueva forma de descubrir y escuchar podcasts en Android.
Listen to podcasts at faster playback speeds or skip over silences.	Escucha podcasts a velocidades de reproducción más altas o sáltate los silencios.
Find the latest episodes of your favorite podcasts directly on your phone.	Encuentra los últimos episodios de tus podcasts favoritos directamente en tu teléfono.
Google Podcasts is a new way for Android users to discover and listen to the world’s podcasts.	Podcasts de Google es una nueva forma de descubrir y escuchar podcasts de todo el mundo en Android.
You can subscribe to any show for free and download episodes for offline listening.	Puedes suscribirte gratuitamente a cualquier programa y descargar episodios para escucharlos sin conexión.
Anyone with this link can see your collection	Los usuarios que tengan este enlace podrán ver tu colección
Turn offline search on or off	Activar o desactivar las búsquedas offline
See or remove searches	Ver o quitar búsquedas
You've helped others make better decisions about places to go	Has ayudado a los demás a decidir mejor a qué sitios ir.
You've helped others make better decisions about places to go.	Has ayudado a otras personas a tomar mejores decisiones acerca de los sitios que pueden visitar.
Failed to move selected items. Try again later.	No se han podido mover los elementos seleccionados. Vuelve a intentarlo más tarde.
Hide name and show number to others	Ocultar el nombre y mostrar el número a otros usuarios
Failed to remove collection. Try again later.	No se ha podido quitar la colección. Vuelve a intentarlo más tarde.
No targets to send to for this input.	No hay destinos para enviar para esto.
All items in this collection will be removed.  Are you sure you want to remove this collection?	Se quitarán todos los elementos de esta colección. ¿Seguro que quieres quitarla?
Type any email address	Escribe cualquier dirección de correo electrónico
Failed to create collection. Try again later.	No se ha podido crear la colección. Vuelve a intentarlo más tarde.
Type a name or email	Escribe un nombre o un correo electrónico
Only editable in Maps	Solo se puede editar en Maps
Edit collection in Maps	Editar colección en Maps
Failed to rename collection. Try again later.	No se ha podido cambiar el nombre de la colección. Vuelve a intentarlo más tarde.
Failed to delete selected items. Try again later.	No se han podido eliminar los elementos seleccionados. Vuelve a intentarlo más tarde.
To make sharing easier, Google suggests people to share with based on your interactions	Google te ayuda a compartir contenido de manera más sencilla sugiriéndote personas a quien enviárselo en función de tus interacciones
Access sports in one tap	Accede a los deportes con un solo toque
Get back here in one tap	Accede aquí con un solo toque
Add a shortcut to sports	Añade un acceso directo a los deportes
Is there flood damage around you?	¿Hay daños por la inundación a tu alrededor?
Do you see earthquake damage around you?	¿Ves daños por el terremoto a tu alrededor?
See results in English	Ver resultados en inglés
You looked this up	Lo que has buscado
Tap on the tags below to vote	Toca las etiquetas que aparecen más abajo para votar
How would you describe this movie?	¿Cómo describirías esta película?
Add your vote to help others	Añade tu voto para ayudar a otros usuarios
Unavailable for this word	No disponible para esta palabra
Easy checkout with Google	Tramitación sencilla de la compra con Google
Tell me what you think of this one	A ver qué te parece este
Hey, I know some riddles 😀	Algún acertijo seguro que se me ocurre 😀
Hey, I know some jokes 😀	Algún que otro chiste me sé 😀
Your ad was disapproved	Tu anuncio ha sido rechazado
Thank you! Your response was recorded.	Gracias. Se ha registrado tu respuesta.
A new version is available	Hay una nueva versión disponible
Prasanta Chandra Mahalanobis’ 125th birthday	125.º aniversario del nacimiento de Prasanta Chandra Mahalanobis
Dame Cicely Saunders’ 100th Birthday	100.º aniversario del nacimiento de Dame Cicely Saunders
What do you think about this album?	¿Qué te ha parecido este álbum?
What do you think about this book?	¿Qué te ha parecido este libro?
Your feedback helps others decide which albums to listen to.	Tus comentarios ayudan a otros usuarios a decidir qué álbum escuchar.
Your feedback helps others decide which video games to play.	Tus comentarios ayudan a otros usuarios a elegir videojuegos.
Your feedback helps others decide which books to read.	Tus comentarios ayudan a otros usuarios a decidir qué libro leer.
What do you think about this video game?	¿Qué te ha parecido este juego?
world cup top teams	mejores equipos del mundial
world cup next match	próximo partido del mundial
Dates are not final and may change	Las fechas no son definitivas y es posible que cambien
Tap a match to see stats, news, and more	Toca un partido para ver estadísticas, noticias y mucho más
Easily keep track of your episodes	Controla fácilmente por qué episodio vas
Bringing the best of Google to podcasts	Disfruta de tus podcasts con las mejores funciones de Google
You liked this album	Te ha gustado este álbum
You liked this book	Te ha gustado este libro
You liked this movie	Te ha gustado esta película
You liked this video game	Te ha gustado este videojuego
mohammad al-sahlawi news	noticias de mohammad al-sahlawi
heung-min son news	noticias de son heung-min
kevin de bruyne news	noticias de kevin de bruyne
Suggestions based on your search and browsing history	Sugerencias basadas en tu historial de búsqueda y navegación
Scores are live. Tap to see the match timeline and news.	Los resultados se actualizan en directo. Toca para ver las noticias y el resumen del partido.
Scores are live. Tap to see the game timeline and news.	Los resultados se actualizan en directo. Toca para ver las noticias y el resumen del partido.
New content loaded successfully. Scroll down to read more.	Se ha cargado el nuevo contenido. Desplázate hacia abajo para seguir leyendo.
Unable to load more	No se puede cargar más
In your post, mention that you already followed the troubleshooting steps in this article.	Al escribir en el foro, menciona que ya has seguido los pasos que se indican en este artículo.
Posted by Martin Splitt, Webmaster Trends Analyst	Publicado por Martin Splitt, analista de Tendencias de Webmasters
We also repeated a few key points that web developers should have an eye on when building websites, such as:	También hemos recalcado en qué aspectos deben fijarse los programadores web al crear sitios web, como:
to help webmasters understand what prospective users search for.	para que los webmasters sepan qué buscan los clientes potenciales.
wrapped up, it’s a great time to reflect on some of the highlights.	, es el momento perfecto para repasar la información más destacada del evento.
Do you manage this online presence?	¿Gestionas esta presencia online?
Get reminders and live score notifications for all matches	Recibe recordatorios y notificaciones con resultados en directo de todos los partidos
Send a message to this business.	Envía un mensaje a esta empresa.
Dr. Virginia Apgar’s 109th Birthday	109.º aniversario del nacimiento de la Dra. Virginia Apgar
Make Google my default search engine	Establecer Google como mi buscador predeterminado
This hotel has exclusive prices for Google One members	Este hotel ofrece precios exclusivos a los miembros de Google One
You’ll be notified with results	Recibirás una notificación con los resultados
Check your connection and try again	Comprueba tu conexión e inténtalo de nuevo
Google won’t retry this search when you’re back online	Google no repetirá esta búsqueda cuando vuelvas a tener conexión
Google will retry your search once you’re online again	Google repetirá esta búsqueda cuando vuelvas a tener conexión
To run your ad, review and edit your text.	Para publicar el anuncio, revisa y edita el texto.
To run your ad, make a payment.	Para publicar el anuncio, haz un pago.
To run your ad, update your billing.	Para publicar el anuncio, actualiza la información de facturación.
You can also choose whether you want to open links to maps in Google Maps.	También puedes decidir si quieres que los enlaces a mapas se abran con Google Maps.
This won’t clear searches you’ve done on other devices or computers.	Con esta opción, no se borran las búsquedas que hayas hecho en otros dispositivos u ordenadores.
What other apps you have on your device	Las aplicaciones que tienes en tu dispositivo
For example, you can search for information about your upcoming flights or restaurant reservations.	Por ejemplo, puedes buscar información sobre tus próximos vuelos o reservas en restaurantes.
Pink the language for your search results.	Puedes elegir el idioma en el que quieres ver tus resultados de búsqueda.
Change the settings that control voice search and voice actions.	Puedes cambiar los ajustes que controlan la búsqueda por voz y las acciones de voz.
Number of rows per page	Número de filas por página
Have you ever consented to the distribution of the fake images or videos?	¿Alguna vez has dado tu consentimiento para distribuir las imágenes o los vídeos falsos?
Yes, but not on this site.	Sí, pero no en este sitio web.
Please enter a valid email address	Introduce una dirección de correo electrónico válida.
In the top right corner of the page, click the gear icon.	En la esquina superior derecha de la página, haz clic en el icono de rueda dentada.
Get reminders and live score notifications for all games	Recibe recordatorios y notificaciones con resultados en directo de todos los partidos
Satisfied with these results?	¿Estás satisfecho con restos resultados?
Ministry of Islamic Affairs, Morocco	Ministerio de Asuntos Islámicos, Marruecos
Click for more results	Haz clic para ver más resultados
Customized stickers based on you	Pegatinas a tu imagen y semejanza
Weather update for a place	Viste información actualizada sobre el tiempo de un sitio
Viewed a notification about a promotion	Viste una notificación sobre una promoción
Received a notification about a promotion	Recibiste una notificación sobre una promoción
Received a notification about a declined payment	Recibiste una notificación sobre un pago rechazado
Received a notification about a backup payment method	Recibiste una notificación sobre un método de pago alternativo
Voted on a poll in	Votaste en una encuesta de
Viewed a notification about a declined payment	Viste una notificación sobre un pago rechazado
Viewed a notification about a backup payment method	Viste una notificación sobre un método de pago alternativo
How Google Shopping works	Cómo funciona Google Shopping
Received a notification about an expiring movie or show	Recibiste una notificación sobre una película o programa a punto de caducar
Save tags and close dialog	Guardar etiquetas y cerrar el cuadro de diálogo
Check your feed for the latest on topics you follow	Consulta en tu tablón las últimas novedades sobre los temas que sigues
Info Google stores about my searches	Información que almacena Google sobre mis búsquedas
We chose these hotels based on emails about hotel reservations in your Gmail account.	Marcamos estos hoteles basándonos en correos electrónicos de reservas de hoteles de tu cuenta de Gmail.
You could also be eligible to see lower prices that aren’t public.	Es posible que también puedas optar a precios más bajos que no son públicos.
Prices are the public rates available from our partners for the dates you selected.	Los precios que se indican son los precios públicos que ofrecen nuestros partners para reservar una habitación durante las fechas seleccionadas.
You can use these ratings to narrow your search.	Puedes utilizar estas valoraciones para acotar la búsqueda.
There are 2 types of deals:	Hay dos tipos de ofertas:
Hotels priced below their normal rate or below the rates of similar hotels nearby.	Hoteles que ofrecen un precio inferior al habitual o que son más baratos que hoteles similares cercanos.
Use the map to see the location and other hotels in the area.	Utiliza el mapa para ver la ubicación y otros hoteles de la zona.
Within the search results, scroll to the hotel results box.	Desplázate hasta el cuadro de resultados de hoteles que aparece en los resultados de búsqueda.
At the bottom of the box, tap or click the link.	Tocando el enlace de la parte inferior del cuadro o haciendo clic en él.
Download your data from Google research studies	Descargar los datos de los estudios de investigación de Google
Failed to update preferences	No se han podido actualizar las preferencias
Reserve room on Google	Reservar habitación en Google
Your Google Express cart	Tu carrito de Google Express
Your cart is empty	Tu carrito está vacío
Ask your customers to write a review and rate your business	Pide a tus clientes que escriban una reseña y valoren tu empresa
At the bottom left, touch and hold the comma.	En la parte inferior izquierda, mantén pulsada la coma.
To confirm that you want to permanently delete these words, enter the number provided.	Para confirmar que quieres eliminar estas palabras de forma permanente, introduce el número proporcionado.
Type in more than one language	Escribir en más de un idioma
Choose languages for Gboard only	Elegir idiomas solo para Gboard
Information Google stores about your medical searches	Información que almacena Google sobre tus búsquedas médicas
Medical information on Google comes from high-quality websites, medical professionals, and search results.	La información médica que se muestra en Google procede de excelentes profesionales médicos, así como de resultados de búsqueda y sitios web de gran calidad.
We check these results for relevance.	Dichos resultados se revisan para comprobar que sean pertinentes.
View lineup and top stories on Google.	Descubre el cartel y consulta las noticias más populares en Google.
Follow the nominees and top stories on Google.	Sigue a los nominados y consulta las noticias más populares en Google.
Awards ceremony is starting now	La ceremonia de premios está comenzando
Viola Desmond’s 104th birthday	104 aniversario del nacimiento de Viola Desmond
Kurt Masur’s 91st Birthday	91 aniversario del nacimiento de Kurt Masur
Lyudmila Rudenko’s 114th Birthday	114 aniversario del nacimiento de Lyudmila Rudenko
Mehdi Hassan’s 91st birthday	91 aniversario del nacimiento de Mehdi Hassan
María Rebeca Latigo de Hernández’s 122nd Birthday	122 aniversario del nacimiento de María Rebeca Latigo de Hernández
Carlota Jaramillo’s 114th Birthday	114 aniversario del nacimiento de Carlota Jaramillo
Georges Lemaître’s 124th Birthday	124 aniversario del nacimiento de Georges Lemaître
Feroza Begum’s 88th Birthday	88 aniversario del nacimiento de Feroza Begum
Gino Bartali’s 104th Birthday	104 aniversario del nacimiento de Gino Bartali
Full cast, reviews and more	Reparto completo, reseñas y más datos
See a search result.	Consulta un resultado de búsqueda.
Tap an instant result or finish typing.	Toca un resultado instantáneo o termina de escribir.
In the search bar, start typing.	Empieza a escribir en la barra de búsqueda.
Below the emojis, tap an emoji category.	O bien, debajo de los emojis, toca una categoría.
A word will show in the message field.	Se mostrará una palabra en el campo del mensaje.
To add this shortcut:	Para añadir este acceso directo:
Hotels where a partner is offering a discount compared to the current market price for that hotel.	Hoteles para los que un partner ofrece un descuento en comparación con el precio de mercado actual de ese hotel.
Search for hotels on Google	Buscar hoteles en Google
Select a Google Photo Album	Seleccionar un álbum de Google Fotos
Games, news, and standings	Partidos, noticias y clasificación
Win probability not available after 80th minute	La probabilidad de victoria no está disponible después del minuto 80
Is it flooded around you?	¿Hay zonas inundadas a tu alrededor?
Reorder with Google Express	Volver a comprar con Google Express
total includes taxes + fees	el total incluye impuestos y tasas
Deleting this entry will unenroll you from the promotion.	Si eliminas esta entrada, se anulará tu inscripción en la promoción.
Provided feedback about a contactless payment issue	Has proporcionado información acerca de un problema de pago contactless
Receive updates about new features and best practices	Recibir novedades sobre funciones y prácticas recomendadas
Read a book in Play Books	Has leído un libro en Play Libros
Watched a movie in Play Movies	Has visto una película en Play Películas
Clicked on a notification about a backup payment method	Has hecho clic en una notificación sobre un método de pago alternativo
Clicked on a notification about an expiring voucher	Has hecho clic en una notificación sobre un cupón que va a caducar
Clicked on a notification about a lower price	Has hecho clic en una notificación sobre un precio más bajo
Clicked on a notification about a declined payment	Has hecho clic en una notificación sobre un pago rechazado
Clicked on a notification about an expiring movie or show	Has hecho clic en una notificación sobre una película o programa que va a caducar
Clicked on a notification about a promotion	Has hecho clic en una notificación sobre una promoción
Deleted activity from all time	Se ha eliminado la actividad desde siempre
Showing English and Hindi definitions together.	Las definiciones en inglés y en hindi se muestran juntas.
Tap to switch languages.	Toca para cambiar los idiomas.
Not available on this device	No disponible en este dispositivo
Most asked on Google	Muy preguntado en Google
Get it with Google Express	Consigue este producto con Google Express
Marga Faulstich’s 103rd birthday	103.° aniversario del nacimiento de Marga Faulstich
Celebrating James Wong Howe	Homenaje a James Wong Howe
Prices unavailable for these dates	No hay precios disponibles para estas fechas
You can also update by downloading the latest version of WordPress.	También puedes actualizarlo descargando la última versión de WordPress.
Expiring movie or show	Película o programa a punto de caducar
Report a problem with the map	Notificar un problema con el mapa
Report a problem with the results	Notificar un problema con los resultados
Report a problem with this question	Notificar un problema con esta pregunta
Report a problem with the directions	Notificar un problema con las indicaciones
Post updates on Google	Publicar actualizaciones en Google
Create posts that appear instantly on Google Search results	Crea publicaciones que se mostrarán instantáneamente en los resultados de la Búsqueda de Google
Tip: Add any location to the search box	Consejo: Añade cualquier ubicación en la barra de búsqueda
Are you sure? Your changes will be public on Google Search.	¿Seguro? Los cambios aparecerán públicamente en la Búsqueda de Google.
Create a story on Google	Crear una historia en Google
This name will appear on Google	Este nombre aparecerá en Google
Pro Tools Session Preparataion	Preparación de Sesión con Pro Tools
Catch more of the behind-the-scenes action in the video below!	Descubre más momentos de primera mano en el siguiente vídeo.
Colors were also very important.	Los colores también tenían un papel muy importante.
He created and painted all the assets himself!	¡Imaginó y pintó todos los elementos él solo!
He saw film and cameras as more than just tools to capture images.	Para él, la película y la cámara eran algo más que simples herramientas para capturar imágenes;
Doodler and project art lead Helene Leroux shares a behind-the-scenes look of the development of the Doodle:	Hélène Leroux, creadora de doodles y directora Artística de Proyecto, muestra de primera mano cómo se desarrolló el doodle:
Both of the examples above bring us to another major contribution of his pioneering mind: special effects.	Los dos ejemplos anteriores nos llevan a otra de las principales contribuciones de su mente innovadora: los efectos especiales.
Saved to your default Shortlist:	Guardado en tu lista predeterminada:
Institute of Geophysics, University of Tehran	Instituto de Geofísica de la Universidad de Teherán
View and manage your Google Play Developer account	Ver y administrar tu cuenta de desarrollador de Google Play
Tom Longboat’s 131st Birthday	131.º aniversario del nacimiento de Tom Longboat
Virginia Apgar’s 109th Birthday	109.º aniversario del nacimiento de Virginia Apgar
Prasanta Chandra Mahalanobis’s 125th birthday	125.º aniversario del nacimiento de Prasanta Chandra Mahalanobis
Saloua Raouda Choucair’s 102nd Birthday	102.º aniversario del nacimiento de Saloua Raouda Choucair
Gauhar Jaan’s 145th birthday	145.º aniversario del nacimiento de Gauhar Jaan
Heinz Sielmann’s 101st Birthday	101.º aniversario del nacimiento de Heinz Sielmann
George de Mestral’s 111th Birthday	111.º aniversario del nacimiento de George de Mestral
José Emilio Pacheco’s 79th birthday	79.º aniversario del nacimiento de José Emilio Pacheco
Celebrating Jang Yeong-sil	Homenaje a Jang Yeong-sil
Dame Cicely Saunders’s 100th Birthday	100.º aniversario del nacimiento de Dame Cicely Saunders
New results loaded inline, please go to the next result.	Se han cargado nuevos resultados insertados. Ve al siguiente resultado.
Retry failed searches in the background	Volver a realizar búsquedas fallidas en segundo plano
View previous posts on Google	Ver publicaciones anteriores en Google
Show this code at the store	Muestra este código en la tienda
switch from degrees to radians	cambiar de grados a radianes
switch from radians to degrees	cambiar de radianes a grados
Google is not a party to the product sale	Google no participa en la venta de productos
Browse some featured items sold here.	Descubre algunos de los artículos destacados que se venden aquí.
Add an image to each page to publish	Añade una imagen a todas las páginas que quieras publicar
Verify your age for your Google account	Verifica tu edad en tu cuenta de Google
No updates available for this flight	No hay actualizaciones disponibles sobre este vuelo
Drag and zoom to crop the image	Arrastra la imagen y usa el zoom para recortarla
Verify your age for this session	Verifica tu edad para esta sesión
This will help improve search results for everyone.	Con esta acción, ayudas a mejorar los resultados de búsqueda para todos.
Get the answer you’re looking for added to the web	Haz una pregunta para que se añada la respuesta a la Web
Are you sure you want to remove this link?	¿Seguro que quieres quitar este enlace?
Are you sure you want to remove this caption?	¿Seguro que quieres quitar este subtítulo?
Upload an image to all pages to add another	Sube una imagen a todas las páginas para añadir otra
Upload an image to all previous pages to add another page.	Sube una imagen a todas las páginas anteriores para añadir otra página.
We're sorry, but you have sent too many requests to us recently. Please try again later.	Lo sentimos; nos has enviado demasiadas solicitudes recientemente. Vuelve a intentarlo más tarde.
We're sorry, but you do not have access to this page.	Lo sentimos, pero no tienes acceso a esta página.
That’s all we know.	Esa es toda la información que tenemos.
There was an error. Please try again later.	Se ha producido un error. Inténtalo de nuevo más tarde.
Is your phone number correct?	¿El número de teléfono es correcto?
Make sure customers can call you directly	Asegúrate de que los clientes te puedan llamar directamente
Keeping photos fresh helps build your online presence	Actualizar las fotos ayuda a desarrollar tu presencia online
More about George Melies	Más información sobre George Méliès
Add a caption to your page	Añadir un título a la página
Are you sure you want to remove this page?	¿Seguro que quieres quitar esta página?
Net change in cash	Variación neta de fondos
To publish, add an image to all pages	Para publicarlo, añade una imagen a cada página
To modify an image or fact, you can suggest an edit	Para modificar una imagen o un dato, puedes sugerir un cambio.
Share fresh updates with people who are eager to hear from you	Comparte las novedades con las personas más interesadas en saber de ti.
Double tapping the space bar will insert a period followed by a space.	Insertar un punto seguido de un espacio al tocar dos veces la barra espaciadora
Add or change info	Añadir o cambiar información
More financial info and news	Más información y noticias financieras
This email has already been saved	Este correo electrónico ya se ha guardado
Enter a valid email address and try again.	Escribe una dirección de correo electrónico válida e inténtalo de nuevo.
Cancel changes to visibility time	Cancelar los cambios de la hora de visibilidad
Visibility time must be after publish time	La hora de visibilidad debe ser posterior a la hora de publicación
We will respond to clear notices of alleged copyright infringement.	Ante muestras evidentes de presuntas infracciones de derechos de autor, tomaremos las medidas pertinentes.
Images or video should include no nudity or sex acts.	El contenido de imágenes o vídeos no debe incluir desnudos ni actos sexuales.
You can delete saved words whenever you want.	y puedes eliminarlas en cualquier momento.
Delete saved words from Gboard	Eliminar palabras guardadas de Gboard
Saved words on your device aren’t sent.	Tampoco se envían las palabras guardadas en el dispositivo.
To add Gboard back to your keyboard list:	Para volver a añadir Gboard a la lista:
If these steps don’t work, try restarting your phone.	Si estos pasos no te funcionan, prueba a reiniciar el teléfono.
Gboard is no longer in my keyboard list	Gboard ya no está en mi lista de teclados
Slide your finger across the letters of the word you want, then lift your finger.	Desliza el dedo por las letras de la palabra que quieras escribir y, a continuación, levanta el dedo.
On your iPhone or iPad, open Gboard.	En tu iPhone o iPad, abre Gboard.
To fix the issue, remove Gboard from your keyboard list, then add it back.	Para solucionar el problema, retira Gboard de la lista de teclados y vuelve a añadirlo.
To edit a word, type the changes or choose a suggestion below the message field.	Para editar una palabra, escribe los cambios o elige una sugerencia debajo del campo del mensaje.
Tap one or more emojis you want.	Toca uno o más emojis.
Or below the emojis, tap an emoji category.	O bien, debajo de los emojis, toca una categoría de emojis.
Send emojis or GIFs	Enviar emojis o GIFs
Tap the card you want to share.	Toca la tarjeta que quieras compartir.
On your iPhone or iPad, while in an app, open Gboard.	En tu iPhone o iPad, cuando estés en una aplicación, abre Gboard.
Make Gboard your default keyboard	Convertir Gboard en el teclado predeterminado
Search Google and send results	Buscar en Google y enviar los resultados
You can switch to another keyboard any time.	Puedes usar otro teclado en cualquier momento.
On your iPhone or iPad, open an app, then tap the message field.	En tu iPhone o iPad, abre una aplicación y, a continuación, toca el campo del mensaje.
To search Google or GIFs, connect to Wi-Fi or a cellular network.	Para buscar algo en Google o elegir un GIF, conéctate a una red Wi‑Fi o móvil.
Then, you can share your search results.	y luego compartir los resultados de tu búsqueda.
Languages available: English, Spanish, German, French, Italian, and Portuguese	Idiomas disponibles: alemán, español, francés, inglés, italiano y portugués.
Search and send GIFs and emojis.	Buscar y enviar GIFs y emojis.
The switch should be green.	El interruptor debe estar en verde.
To edit a word, type the changes or choose a suggestion below the message field.	Para editar una palabra, escribe los cambios o elige una sugerencia debajo del campo del mensaje.
Then lift your finger.	A continuación, levanta el dedo.
Tap the language to translate into.	Toca el idioma de destino.
Tap one or more emojis.	Toca uno o más emojis.
Then you can share your search results.	y luego compartir los resultados de tu búsqueda.
To search Google or GIFs, connect to Wi-Fi or a mobile network.	Para buscar algo en Google o elegir un GIF, conéctate a una red Wi‑Fi o móvil.
While in an app, open Gboard.	Cuando estés en una aplicación, abre Gboard.
To type in more than one language, choose your languages.	Para escribir en más de un idioma, elige los que quieras usar.
Add Google Search button	Añadir el botón de la Búsqueda de Google
Choose languages for your phone	Elegir los idiomas del teléfono
Use more than one language in the same conversation.	Usar más de un idioma en la misma conversación.
Search and send GIFs, emojis, and stickers.	Buscar y enviar GIFs, emojis y pegatinas.
Tip: Location can be changed in the search box. Nearby cities appear here.	Consejo: Puedes cambiar la ubicación en la barra de búsqueda. Ciudades cercanas aparecerán en esta sección.
Contact this property for rates and availability	Ponte en contacto con esta propiedad para preguntar sobre tarifas y disponibilidad
Mrinalini Sarabhai’s 100th Birthday	100 aniversario del nacimiento de Mrinalini Sarabhai
Raja Ram Mohan Roy’s 246th Birthday	246 aniversario del nacimiento de Raja Ram Mohan Roy
Milton Santos’s 92nd Birthday	92 aniversario del nacimiento de Milton Santos
Radwa Ashour’s 72nd Birthday	72 aniversario del nacimiento de Radwa Ashour
Levi Celerio’s 108th Birthday	108 aniversario del nacimiento de Levi Celerio
Tamara de Lempicka’s 120th Birthday	120 aniversario del nacimiento de Tamara de Lempicka
Sam Selvon’s 95th Birthday	95 aniversario del nacimiento de Sam Selvon
Maria Reiche’s 115th Birthday	115 aniversario del nacimiento de Maria Reiche
Dadasaheb Phalke’s 148th Birthday	148 aniversario del nacimiento de Dadasaheb Phalke
Hedwig Kohn’s 131st Birthday	131 aniversario del nacimiento de Hedwig Kohn
Chote Praepan’s 111th Birthday	111 aniversario del nacimiento de Chote Praepan
Johann Carl Friedrich Gauß’s 241st Birthday	241 aniversario del nacimiento de Johann Carl Friedrich Gauss
Average net cost after aid	Coste neto medio con la ayuda
Average cost before aid	Coste medio con la ayuda
No network available. Check your connection and try again.	No hay ninguna red disponible. Comprueba tu conexión y vuelve a intentarlo.
Help others with these English translations:	Ayuda a otros usuarios traduciendo esto desde el inglés:
Help translate this title?	¿Quieres ayudar a traducir este título?
Tuition, fees, and annual cost	Matrícula, gastos administrativos y coste anual
Social and economic diversity	Diversidad social y económica
Google Express works with stores to make checkout easy and protect your order	Google Express trabaja con las tiendas para facilitar la tramitación de la compra y proteger tu pedido
Estimated pickup: Not available	Hora de recogida estimada: no disponible
Based on ratings and visits	Según las valoraciones y las visitas
Estimated delivery: Not available	Hora de entrega estimada: no disponible
Francisco Balagtas’ 230th Birthday	230 aniversario del nacimiento de Francisco Balagtas
Milton Santos’ 92nd Birthday	92 aniversario del nacimiento de Milton Santos
Farouque Shaikh’s 70th Birthday	70 aniversario del nacimiento de Farouque Shaikh
Failed to make contactless payment	No se ha podido efectuar el pago contactless
Dr. Maya Angelou’s 90th Birthday	90 aniversario del nacimiento de la Dra. Maya Angelou
Depending on the type of place you searched, you could see some of these filters:	Según el tipo de sitio que hayas buscado, podrían mostrarse algunos de estos filtros:
Ways to filter search results	Formas de filtrar los resultados de búsqueda
On your computer, in a browser like Chrome or Firefox, do a search on Google.	En tu ordenador, haz una búsqueda en Google usando un navegador como Chrome o Firefox.
On your mobile device, in a mobile browser like Chrome or Safari, do a search on Google.	En tu dispositivo móvil, haz una búsqueda en Google usando un navegador como Chrome o Safari.
Add or remove filters	Añadir o quitar filtros
Latest posts from this business	Últimas publicaciones de esta empresa
Import or download your portfolio	Importar o descargar una cartera
Turn on email alerts for this search	Activar alertas de correo para esta búsqueda
Alerts are on for this search	Alertas para esta búsqueda activadas
They may also be based on:	Es posible que también estén basados en:
Your visits to other websites and apps	Tus visitas a otros sitios web y aplicaciones
It may also be based on:	Es posible que también esté basado en:
Financial news, comparisons and more	Noticias financieras, comparaciones y mucho más
Did you find this helpful?	¿Te ha parecido útil?
Deselect filter chips to see more products	Desmarca los filtros para ver más productos
This ad is based on:	Este anuncio se basa en:
Drop photos here to upload	Suelta fotos aquí para subirlas
Open in new window	Abrir en una ventana nueva
Which team do you think will win the upcoming match?	¿Qué equipo crees que ganará el próximo partido?
Which team do you think will advance to the next round?	¿Qué equipo crees que pasará a la siguiente ronda?
Who do you think will advance to the next round?	¿Quién crees que pasará a la siguiente ronda?
Who do you think will win the upcoming match?	¿Quién crees que ganará el próximo partido?
Now in theaters · Critic reviews available	En cartelera · Reseñas de críticos disponibles
Now in theaters · Metacritic rating available	En cartelera · Valoración de Metacritic disponible
Now in theaters · Rotten Tomatoes rating available	En cartelera · Valoración de Rotten Tomatoes disponible
Now in theaters · Trailer available	En cartelera · Tráiler disponible
Now in theaters · IMDb rating available	En cartelera · Valoración de IMDb disponible
Now in theaters · Cast available	En cartelera · Reparto disponible
Tamara de Lempicka’s 120th birthday	120 aniversario del nacimiento de Tamara de Lempicka
Mrinalini Sarabhai’s 100th birthday	100 aniversario del nacimiento de Mrinalini Sarabhai
Raja Ram Mohan Roy’s 246th birthday	246 aniversario del nacimiento de Raja Ram Mohan Roy
Radwa Ashour’s 72nd birthday	72 aniversario del nacimiento de Radwa Ashour
Sam Selvon’s 95th birthday	95 aniversario del nacimiento de Sam Selvon
Milton Santos’s 92nd birthday	92 aniversario del nacimiento de Milton Santos
Chote Praepan’s 111th birthday	111 aniversario del nacimiento de Chote Praepan
Maria Reiche’s 115th birthday	115 aniversario del nacimiento de Maria Reiche
This will permanently remove all the visits at this place from your Timeline.	Se quitarán definitivamente de tu cronología todas las visitas a este sitio.
Remove this place from your Timeline?	¿Quieres quitar este sitio de tu cronología?
Rate to improve your recommendations	Puntúa para obtener mejores recomendaciones
Comments will be visible to others and identified by your Google Account nickname.	Los comentarios aparecerán identificados por el apodo de tu cuenta de Google y los demás usuarios podrán verlos.
Get it in your calendar	Apúntalo en tu calendario
Upgrade to a smarter calendar	Actualiza a un calendario más inteligente
Spreads through contaminated food or water	Se contagia a través de alimentos o agua contaminados
Through contaminated food or water.	Por alimentos o agua contaminados.
30th Anniversary of Pi Day!	30 aniversario del Día del número Pi
Test run by Measurement Lab	Prueba ejecutada por Measurement Lab
Tapped with Google Pay	Tramitado con Google Pay
The type of communication used the first time you connect with someone.	Tipo de comunicación utilizada la primera vez que contactas con alguien.
Scholar Profiles provide a simple way for authors to keep track of citations to their published articles	Con los perfiles de Académico, los autores pueden hacer fácilmente el seguimiento de las citas de sus artículos publicados
Monitor the Web for new content	Supervisa la Web y encuentra nuevo contenido
Google Calendar helps you set and achieve long term goals	Google Calendar te ayuda a definir y lograr objetivos a largo plazo
Tap hours to see times	Toca las horas para ver la afluencia
Show this code at the store.	Muestra este código en la tienda.
Click hours to see times	Haz clic en las horas para ver la afluencia
Tap to view prices	Toca para ver precios
View and manage web hosting plans and resource records for your domains	Ver y administrar planes de alojamiento web y registros de recursos de tus dominios
View web hosting plans and resource records for your domains	Ver planes de alojamiento web y registros de recursos de tus dominios
Can have no symptoms, but people may experience:	La enfermedad puede ser asintomática, pero la gente puede sufrir:
Web pages that include matching image	Páginas web que incluyen imágenes coincidentes
Processed by Google Payments Corp.	Tramitada por Google Payments Corp.
Find your saved events here	Los eventos que has guardado están aquí
Control the data Play Console uses to personalize your experience.	Controla los datos que usa Play Console para personalizar tu experiencia.
Visit Play Console settings	Visitar la configuración de Play Console
Saving an event will add it to this tab so that you can find it later.	Si guardas un evento, se añadirá a esta pestaña para que puedas encontrarlo después más fácilmente.
RETURN TO SEARCH RESULTS	VOLVER A LOS RESULTADOS DE BÚSQUEDA
Processed by Google Payment Corp	Tramitado por Google Payment Corp.
Hedwig Kohn’s 131st birthday	131 aniversario del nacimiento de Hedwig Kohn
Make sure the following settings are on	Asegúrate de que estos ajustes estén activados
Thank you for your input. Your suggestions help improve Google search.	Gracias por tu comentario. Tus sugerencias ayudan a mejorar la Búsqueda de Google.
Your question will not be submitted	No se enviará tu pregunta
No providers match your search.	No hay ningún proveedor que coincida con tu búsqueda.
Confirm the service and ZIP code, and try again.	Confirma el servicio y el código postal, e inténtalo de nuevo.
Note: Not all providers offer all services	Nota: No todos los proveedores ofrecen todos los servicios
Enter a ZIP code to find local pros	Introduce un código postal para encontrar profesionales locales
Try searching over a larger date range.	Intente buscar en un intervalo de fechas mayor.
Something has gone wrong... Try again.	Algo no ha ido bien. Vuelve a intentarlo.
Orhan Veli Kanık’s 104th Birthday	104 aniversario del nacimiento de Orhan Veli Kanık
Slow to load? Try an optimized page.	¿La carga es lenta? Prueba con una página optimizada.
30th Anniversary of Pi Day	30 aniversario del Día del número Pi
Hung Kings Commemoration Day	Día de Conmemoración de los Reyes Hung
RECENTLY VIEWED, AVAILABLE HERE	VISTOS RECIENTEMENTE Y DISPONIBLES AQUÍ
You can now search by voice in multiple languages.	ahora puedes hacer búsquedas por voz en varios idiomas.
This email is already in the system	Este correo electrónico ya está en el sistema
All items in this collection will be removed. Are you sure you want to remove this collection?	Se quitarán todos los elementos de esta colección. ¿Seguro que quieres quitarla?
only available on mobile devices	solo disponible en dispositivos móviles
View list in events	Ver lista en Eventos
Double tap to manage your home control settings.	Toca dos veces para administrar los ajustes de domótica.
Home Control is not yet supported.	Todavía no soy compatible con la domótica.
View medal counts and top news on Google.	Consulta el recuento de medallas y las noticias destacadas en Google.
This action cannot be undone.	Esta acción no puede deshacerse.
Nazia Hassan’s 53rd Birthday	53 aniversario del nacimiento de Nazia Hassan
Maya Angelou’s 90th Birthday	90 aniversario del nacimiento de Maya Angelou
Fanny Blankers-Koen’s 100th Birthday	100 aniversario del nacimiento de Fanny Blankers-Koen
Francisco Balagtas’s 230th Birthday	230 aniversario del nacimiento de Francisco Balagtas
Levi Celerio’s 108th birthday	108 aniversario del nacimiento de Levi Celerio
Kamaladevi Chattopadhyay’s 115th Birthday	115 aniversario del nacimiento de Kamaladevi Chattopadhyay
John Harrison’s 325th Birthday	325 aniversario del nacimiento de John Harrison
Dadasaheb Phalke’s 148th birthday	148 aniversario del nacimiento de Dadasaheb Phalke
Johann Carl Friedrich Gauß’s 241st birthday	241 aniversario del nacimiento de Johann Carl Friedrich Gauss
Celebrating Freedom Day and Ahmed Kathrada	Celebración del Día de la Libertad y homenaje a Ahmed Kathrada
177th Anniversary of Semper Opera House	177 aniversario del teatro de ópera Semperoper
More travel inspiration and trip ideas	Más ideas de viajes
Some results are not shown.	Algunos resultados no se muestran.
Debug remote Chrome instances	Depurar instancias remotas de Chrome
Send a digital gift to someone you like	Envía un regalo digital a alguien especial para ti
Get the search results most relevant to you	Obtén los resultados de búsqueda más relevantes para ti
Create mailing lists and discussion groups	Crea listas de distribución y grupos de debate
Upload photos and videos to Google+ from your device with Auto Backup.	Subir fotos y vídeos a Google+ desde su dispositivo usando la función de copia de seguridad automática
Adjust bid and budget for your AdWords account based on its historical data.	Ajusta la puja y el presupuesto de tu cuenta de AdWords a partir de los datos del historial.
Compare the world's interest in your favourite topics.	Compare el interés de otros en sus temas preferidos.
Register a domain, get hosting, and build a website with Google Domains.	Registra un dominio, consigue alojamiento y desarrolla un sitio web con Google Domains.
Find new 3rd party solutions to complement your Google products	Localiza nuevas soluciones de terceros que complementen tus productos de Google.
Common APIs for Google Apps Data	API comunes de datos de Google Apps
Post your products on Merchant Center, find them on Google.	Publica tus productos en Merchant Center y encuéntralos en Google.
Backup and download the data in your Google Account.	Utiliza tu cuenta de Google para hacer una copia de seguridad de tus datos y descargarlos.
An easy way to share content online	Una forma fácil de compartir contenidos online
Ask a question. Set your price. Get your answer.	Envía una pregunta, indica un precio y obtén una respuesta.
Store and share photos online with Google Photos and Picasa Web Albums	Almacena y comparte fotos online con Google Fotos y Álbumes web de Picasa
Develop applications using Google APIs and the Google Cloud Platform.	Desarrolla aplicaciones usando las API de Google y la APIs y la Google Cloud Platform.
Find events anytime and anywhere	Busca eventos que se celebren en cualquier momento y en cualquier lugar.
Google services for small and medium businesses	Servicios de Google para la pequeña y mediana empresa
Connect to Wi-Fi networks	Conectarse a redes Wi-Fi
Frontend for Google travel - flights, hotels and travel-assistant.	Interfaz para Google Travel: vuelos, hoteles y asistente para viajes
Manage health information securely and get trustworthy guidance	Gestiona la información sobre salud de forma segura y obtén una orientación fiable.
Create and search ads	Crear y buscar anuncios
Get your business on Google for free with Google My Business	Haz que tu empresa aparezca en Google de forma gratuita con Google My Business.
Help the world find your content	Ayuda a los demás usuarios a encontrar tu contenido
Add news, games and more to the Google homepage	Añade noticias, juegos y muchos elementos más a la página principal de Google.
Connect with a community of trusted friends	Conecta con una comunidad de amigos de confianza.
Google+ Photos Chrome App	Aplicación de Chrome Fotos de Google+
A faster, safer and more convenient way to shop online	Un modo más rápido, seguro y práctico de comprar online.
Manage and optimize pay-per-click advertisements and keywords across all major search engines	Gestiona y optimiza palabras clave y anuncios de pago por clic en los principales motores de búsqueda.
Create your own customized Google News	Crea tu Google Noticias personalizado
Chrome Remote Desktop Directory	Directorio de Escritorio Remoto de Google Chrome
Organize your schedule and share events with friends	Organiza tu agenda y comparte eventos con tus amigos.
Import contacts from remote accounts.	Importar contactos de cuentas remotas.
Upload, share and watch videos on the web	Sube, comparte y reproduce vídeos en la Web.
Find buyers searching for what you sell	Encuentra clientes que busquen exactamente lo que ofreces.
The specified directory is readonly or file exists and is write-protected.	El directorio especificado es de solo lectura o bien el archivo existe pero está protegido contra escritura.
Get real help from real people in real time	Obtén ayuda real de personas reales en tiempo real
Invalid number of fields in cron schedule; five fields are required	Número de campos incorrecto en el programa cron; son necesarios cinco campos
Read Fitness Blood Glucose Data	Leer los datos de glucosa en sangre de Fitness
Where shoppers use the power of Google to find your products.	Aquí los compradores utilizan la potencia de Google para encontrar sus productos.
Get Google's view of your site	Obtén el punto de vista de Google sobre tu sitio.
Connecting donors to charities	Pone en contacto a los donantes con las entidades benéficas.
Quickly post thoughts, interact with people, and more	Expresa rápidamente tus opiniones, interactúa con otros usuarios y un sinfín de cosas más.
Easily create, share, and publish professional maps.	Crea, comparte y publica mapas profesionales fácilmente.
Receive messages from Google services	Permite recibir mensajes desde los servicios de Google.
get local weather updates	obtén la información meteorológica local más reciente
Let's Educators manage a whitelist of YouTube Content appropriate for their Google Apps for Education domain.	Permite a los educadores administrar una lista blanca de contenido de YouTube adecuado para su dominio de Google Apps for Education.
Google Video Search Partner Demo	Demostración de partners en la búsqueda de vídeos de Google
Your direct route to selling and sharing your music with fans	La ruta directa para vender y compartir música con los fans
Track status of your job applications	Supervisa el estado de tus solicitudes de trabajo.
Email address must have a domain name	La dirección de correo electrónico debe contener un nombre de dominio
Please use a combination of digits and letters for your password.	Utilice una combinación de dígitos y letras para la contraseña.
Enable access to Jamboard web and mobile clients	Permite el acceso a la web de Jamboard y a los clientes que acceden desde dispositivos móviles
Google Play Music Songza Account Linkage	Enlace de cuentas de Songza y Google Play Música
Answer the questions your audience cares about.	Responde a las preguntas que preocupan a tu audiencia.
A new way to get online content on your consumer electronics devices	Una nueva forma de obtener contenido online en los dispositivos electrónicos para consumidores
Community based knowledge search	Búsqueda de conocimientos basada en comunidades
Easily create, share, and publish custom maps.	Crea, comparte y publica mapas personalizados al momento.
Search in all your Google Apps	Busque en todas sus aplicaciones de Google
Google+ Pages Additional Terms of Service	Condiciones de Servicio Adicionales de las Páginas de Google+
Email address must have a user name	La dirección de correo electrónico debe contener un nombre de usuario.
Get a monthly summary of your account activity across many Google products	Obtén un resumen mensual de la actividad de tu cuenta en un gran número de productos de Google.
Configure policies for Chrome browsers	Configura políticas para navegadores Chrome.
The file path is invalid.	La ruta del archivo no es válida.
Information when you want it, right on your desktop	La información que necesitas cuando la necesitas en tu ordenador
Advertise your business on the radio	Anuncia tu empresa en la radio.
Jamboard Web and Mobile Apps	Web y aplicaciones móviles de Jamboard
See what the world is searching for - without leaving your seat.	Consulta lo que el mundo está buscando sin necesidad de levantarte del asiento.
Mobile search and personalized pages	Búsqueda para móviles y páginas personalizadas
Email address is too long	Dirección de correo electrónico demasiado larga
Google Account Video Purchases	Compras de vídeo de la cuenta de Google
Explore, Search and Discover	Explora, busca y descubre
Automatically build tables of facts using the web	Crear automáticamente tablas de hechos con la Web
access Google Accounts on your behalf	acceder a Cuentas de Google en tu nombre
Google stands behind your shopping experience.	Google está detrás de su experiencia de compra.
Google Express Fulfillment - View and manage shifts, orders, parcels, and delivery routes.	Google Express Fulfillment - Ver y administrar turnos, pedidos, paquetes y rutas de entrega.
Google Groups for Business	Grupos de Google para empresas
Admin Role Management APIs	APIs de gestión de funciones administrativas
Google+ Photo and Video Uploads	Subida de fotos y vídeos de Google+
Your password contains a dictionary word	Tu contraseña contiene una palabra fácilmente deducible
Get opinions from your friends and other people	Obtenga opiniones de sus amigos y otras personas.
Distribute your Android content to Google Play	Distribuye tu contenido de Android en Google Play.
Create, store and share spreadsheets on the web	Crea, almacena y comparte hojas de cálculo en la Web.
Make your website more effective by testing content	Optimiza tu sitio web mediante pruebas de contenido.
Synchronize your browser settings across computers. Restore tabs and windows from your previous session.	Sincroniza la configuración de tu navegador entre equipos. Restaura las fichas y ventanas de tu sesión anterior.
Access and manage your search history from any computer	Accede y administra fácilmente tu historial de búsquedas  desde cualquier equipo
On-demand services for Google partners	Servicios bajo demanda para partners de Google
Create bookmarks you can access anywhere	Crea marcadores a los que poder acceder desde cualquier sitio.
Web site authoring and hosting services for small businesses	Servicios de creación y alojamiento web para la pequeña empresa
Google Open Content OneBox Service	servicio de OneBox de código fuente abierto de Google
Find downloadable content for your mobile device	Busca contenido que se pueda descargar para tu dispositivo móvil.
Become a Qualified Google Advertising Professional	Conviértete en un miembro cualificado de Google Advertising Professionals.
Email addresses must contain "@"	Las direcciones de correo electrónico deben contener el símbolo "@".
Google Play Music - Your music, always there	Google Play Música: tu música siempre disponible
Help teams communicate, collaborate and get stuff done.	Ayuda a los equipos a comunicarse, colaborar y realizar tareas.
That is not one of the acceptable values	Este no es uno de los valores aceptables
Project Fi is a wireless service from Google for cellphones and tablets.	Project Fi es un servicio inalámbrico de Google para teléfonos móviles y tablets.
Your passwords do not match	Las contraseñas no coinciden
Review your Google Trusted Stores orders.	Revisa tus pedidos de Google Trusted Stores.
Create your own web pages, quickly and easily	Crea tus propias páginas web fácilmente y de forma rápida.
Play Books Partner Center	Centro de Partners de Play Libros
Publish and share photos online with Picasa Web Albums	Publica y comparte fotos online con los álbumes web de Picasa.
Test-drive new Google product demos	Prueba las demostraciones de nuevos productos de Google.
Easily verify and manage site ownership for multiple Google services, using the method that's best for you.	Comprueba y gestiona fácilmente la propiedad de tu sitio web para múltiples servicios de Google usando el método más adecuado para ti.
Google Apps Administrator Control Panel	Panel de control del administrador de Google Apps
Access google services over phone.	Accede a los servicios de Google desde tu teléfono.
Edit documents online with whomever you choose, and then publish and blog them online.	Edita los documentos online con la persona que elijas y publícalos en un blog online.
Keep up with the news and blogs you care about most	Mantente al día de las noticias y de los blogs que más te interesen.
Find local businesses, view maps and get directions	Buscar empresas locales, ver mapas y obtener direcciones
YouTube Partner Syndication Signup	Registro de sindicación de partners de YouTube
Volunteer to translate Google's services into various languages	Colabora de forma voluntaria en la traducción de los servicios de Google a diferentes idiomas.
Google Experts - Get a quick answer from the perfect person in the Googler community	Google Experts: obtén una respuesta rápida de la persona más indicada de la comunidad de Googlers.
Google Apps Application Settings APIs	API de configuración de aplicaciones de Google Apps
Reward yourself for using Google services	Obtén beneficios por utilizar los servicios de Google.
Google Play Music Curation	Selección de Google Play Música
Connect with advertisers who want to create ads	Ponte en contacto con anunciantes que desean crear anuncios.
You are changing the world. We want to help.	Estás cambiando el mundo. Queremos ayudarte.
Find and use all of your Google business products in one place	Busque y utilice todos sus productos empresariales de Google de forma centralizada.
Access and manage your web activity from any computer	Accede y gestiona tu historial de búsquedas desde cualquier equipo.
Hosting for scientific datasets	Alojamiento para bases de datos científicas
Google Trips - Your mobile travel assistant	Google Trips: la ayuda perfecta en el móvil para viajar
Sorry, that is not a valid entry. Please try again.	Esta entrada no es válida. Inténtalo de nuevo.
Get a fresh start with email that has less spam	Comienza desde cero con una cuenta de correo electrónico que reciba menos mensajes de spam.
This is not a number	Este valor no es un número
Google Apps Script Web Request APIs	APIs de solicitud web de Google Apps Script
Google Apps Script External Request APIs	API de solicitud externa de Google Apps Script
Label images to help improve the quality of Google's image search results	Añada etiquetas a las imágenes para mejorar la calidad de los resultados de las búsquedas de imágenes en Google.
Tiles for Google Maps applications	Mosaicos de las aplicaciones de Google Maps
Personalize your Android device by exploring the world of content in Android Market	Para personalizar su dispositivo Android, accede al universo de contenido de Android Market.
Connect with your friends using your cell-phone.	Ponte en contacto con tus amigos a través del móvil.
View and manage Wi-Fi access credentials and credits.	Consulta y administra los créditos y las credenciales de acceso Wi-Fi.
Mobile access to Google services by voice	Acceso móvil a los servicios de Google por voz
Google Ad Creation Marketplace	Mercado para la creación de anuncios de Google
Email address contains invalid user name	La dirección de correo electrónico contiene un nombre de usuario no válido
Put local businesses on Google Maps	Incluye empresas locales en Google Maps.
Email address contains invalid domain name	La dirección de correo electrónico contiene un nombre de dominio no válido.
For uploading mobile content metadata	Para subir metadatos de contenido móvil
Google Play artist hub	Google Play Artist Hub
Required field must not be blank	Campo obligatorio; no debe dejarse en blanco.
Add custom features to Google Search	Añadir funciones personalizadas a la búsqueda de Google
Create a search engine tailored to your needs	Crea un motor de búsqueda adaptado a tus necesidades.
Shop smarter with wishlists of your favorite products	Compra de forma más inteligente incluyendo tus productos preferidos en listas de productos deseados.
Email addresses may not have more than one "@"	Las direcciones de correo electrónico no pueden presentar más de un símbolo "@".
Chat with other users who share your interests	Charla con otros usuarios que compartan tus intereses.
Must not have a fraction	No debe incluir una fracción.
Communities for structured data	Comunidades de datos estructurados
Create, share and publish websites	Cree, comparta y publique sitios web
Learn all about Google's products and services	Más información sobre los productos y servicios de Google
post entries on your behalf	publicar entradas en tu nombre
Google Maps for mobile application	Aplicación de Google Maps para móviles
Earn money by displaying ads on your site	Gana dinero publicando anuncios en tu sitio.
Experimental version of Google search	Versión experimental de Búsqueda de Google
Google Cloud Messaging for Chrome	Mensajería en la nube de Google para Chrome
View and manage your printers in Google Cloud Print	Consulta y administra tus impresoras con Google Cloud Print.
Google Friends and Updates data endpoint	Punto de finalización de Amigos de Google y de Actualizaciones de Google
Operator recognizer for on the fly recognition of utterances.	Dispositivo de reconocimiento de operador para un reconocimiento inmediato de palabras
View and manage your smart home devices	Ver y administrar los dispositivos inteligentes de tu hogar
Double tap to show settings page.	Toca dos veces para mostrar la página de configuración.
Double tap to show recent panes.	Toca dos veces para mostrar los paneles recientes.
Double tap to select, or cycle through panes.	Toca dos veces para seleccionar o para desplazarte por los paneles.
This page checks to see if it's really you sending the requests, and not a robot.	En esta página se comprueba si eres tú quien envía las solicitudes en lugar de un robot.
Share awesome stickers with your friends! Tap the button below to add stickers to share.	¡Comparte pegatinas alucinantes con tus amigos! Toca el botón y añade las que quieras compartir.
Where people from your area are going	Donde van las personas de tu zona
Google Assistant on Chromebook	Asistente de Google en Chromebook
Ships free with code	Envío gratis con el código
Your order is ready for pickup	Ya puedes recoger tu pedido
Search on Google Flights	Buscar en Google Vuelos
Double-click to end this shape.	Haz doble clic para finalizar esta forma.
Double-click to end this line	Haz doble clic para finalizar esta línea.
Zhou Youguang’s 112th Birthday	112 aniversario del nacimiento de Zhou Youguang
Virginia Woolf’s 136th Birthday	136 aniversario del nacimiento de Virginia Woolf
Teresa Teng’s 65th Birthday	65 aniversario del nacimiento de Teresa Teng
Marlene Dietrich’s 116th Birthday	116 aniversario del nacimiento de Marlene Dietrich
Sir William Henry Perkin’s 180th Birthday	180 aniversario del nacimiento de sir William Henry Perkin
Sergei Eisenstein’s 120th Birthday	120 aniversario del nacimiento de Sergei Eisenstein
Paula Modersohn-Becker’s 142nd Birthday	142 aniversario del nacimiento de Paula Modersohn-Becker
Payom Sinawat’s 109th Birthday	109 aniversario del nacimiento de Payom Sinawat
Stephen Keshi’s 56th Birthday	56 aniversario del nacimiento de Stephen Keshi
Shigeru Mizuki’s 96th Birthday	96 aniversario del nacimiento de Shigeru Mizuki
Farouk Shousha’s 82nd Birthday	82 aniversario del nacimiento de Farouk Shousha
Mario Pani’s 107th Birthday	107 aniversario del nacimiento de Mario Pani
Katsuko Saruhashi’s 98th Birthday	98 aniversario del nacimiento de Katsuko Saruhashi
Gabriel Garcia Marquez’s 91st Birthday	91 aniversario del nacimiento de Gabriel García Márquez
Julie Victoire Daubié 194th Birthday	194 aniversario del nacimiento de Julie Victoire Daubié
Guillermo Haro’s 105th Birthday	105 aniversario del nacimiento de Guillermo Haro
Farooq Sheikh’s 70th Birthday	70 aniversario del nacimiento de Farooq Sheikh
Suggestions based on your search history	Sugerencias en función de tu historial de búsqueda
In store - available to order	En tienda: disponible para pedidos
Not a photo or video of the place	No es una foto o vídeo del sitio
Offensive, hateful or sexually explicit	Contenido ofensivo, sexualmente explícito o que incita al odio
Fares and times are estimates	Las tarifas y los tiempos son aproximados
Double tap to select	Toca dos veces para seleccionar
Double tap Gboard to switch keyboards	Toca dos veces Gboard para cambiar de teclado
View and manage your Google Trusted Tester Program data and campaigns	Ver y administrar los datos y las campañas del Programa Tester de Confianza de Google
View and manage your Google Trusted Tester Program data	Permite visualizar y administrar los datos del Programa Tester de Confianza de Google
Match for 15th place	Partido por el 15.º puesto
Match for 13th place	Partido por el 13.º puesto
There should be at least two options and at most six options.	Debe haber entre dos y seis opciones.
Maybe similar images from the web can help you find what you are looking for	Algunas imágenes similares de la Web te pueden ser útiles para encontrar lo que buscas
Visually similar web images	Imágenes visualmente similares de la Web
What do you think about this movie?	¿Qué te ha parecido esta película?
Be the first to review	Sé el primero en escribir una reseña
View the gallery on Google	Ver la galería en Google
Travelers from your area typically stay	Los viajeros de tu zona suelen quedarse
Query and build reports from demographic data	Consulte y cree informes a partir de datos demográficos.
Air quality for your location has declined	La calidad del aire de tu ubicación ha empeorado
View medal counts, daily recap video, and top news on Google.	Consulta el recuento de medallas, el vídeo con resúmenes diario y las noticias destacadas en Google.
Pages including matching image	Páginas en las que se incluye esta imagen
Popular destinations from your area	Destinos populares de tu zona
Sign in to report the weather	Inicia sesión para indicar el tiempo
Search images labeled for reuse	Buscar imágenes etiquetadas para su reutilización
Service type is required	Debes indicar el tipo de servicio
Remove from search history:	Quitar del historial de búsquedas:
Follow your favorite teams to get match reminders and live score notifications	Sigue a tus equipos favoritos para obtener recordatorios de partidos y notificaciones de resultados en directo
Add a Weather shortcut to your home screen	Añade un acceso directo de Weather a tu pantalla de inicio
Win % on 1st serve	Gana % en el primer servicio
Win % on 2nd serve	Gana % en el segundo servicio
Follow teams and leagues to get scores, news, and videos	Sigue los equipos y las ligas para tener acceso a los resultados, noticias y vídeos
Background checked and Insured.	Asegurado y con antecedentes comprobados.
View the contents of your source code repositories	Ver el contenido de tus repositorios de código fuente
Manage the contents of your source code repositories	Administrar el contenido de tus repositorios de código fuente
Write user interactions to your Google Publish repositories	Escribir interacciones de usuario en tus repositorios de Google Publish
Read live content from your Google Publish repositories in staging environments	Leer el contenido publicado de tus repositorios de Google Publish en entornos de prueba
Write user interactions to your Google Publish repositories in staging environments	Escribir interacciones de usuario en tus repositorios de Google Publish de entornos de pruebas
Thanks, if something changes you can submit another report	Gracias. Si se produce algún cambio, puedes enviar otro informe
Thanks for sharing. Your feedback makes a difference.	Gracias por tu colaboración. Tus comentarios son importantes.
Thanks! Your feedback helps others plan their day.	Gracias. Tus comentarios ayudan a los demás a planificar su día.
Thanks for the feedback. Enjoy your day.	Gracias por tus comentarios. Disfruta del día.
Weather changes quickly. Your input makes a difference.	El tiempo cambia muy rápido. Tus comentarios son muy importantes.
Weather changes quickly. Thanks for staying on top of things.	El tiempo cambia muy rápido. Gracias por tu consulta.
Got it. Thanks for your feedback. Stay dry!	Entendido. Gracias por enviarnos tus comentarios. ¡Que no te pille la lluvia!
Your feedback makes a difference. Thanks!	Tus comentarios son importantes. ¡Gracias!
Your feedback makes a difference. Stay dry out there!	Tus comentarios son importantes. ¡Que no se te olvide el paraguas!
Enter a valid ZIP code	Introduce un código postal válido
Error loading reviews. Try again later.	Se ha producido un error al cargar las reseñas. Inténtalo de nuevo más tarde.
Images may be subject to copyright	Las imágenes pueden estar sujetas a derechos de autor
Ready to send with Google Pay	Listo para enviar con Google Pay
Ready to request with Google Pay	Listo para enviar la solicitud con Google Pay
Some activity may not appear yet	Es posible que aún no aparezca toda la actividad
Welcome to My Activity	Te damos la bienvenida a Mi Actividad
More Google flight results	Más resultados de vuelos en Google
View and manage your Git repositories	Consulta y administra tus repositorios de Git.
Manage your Google Publish repositories	Administrar tus repositorios de Google Publish
Manage Google Cloud Platform projects associated with your Google Publish repositories	Administrar los proyectos de Google Cloud Platform asociados a tus repositorios de Google Publish
Manage your Google Publish repositories in staging environments	Administrar tus repositorios de Google Publish en entornos de prueba
Manage your data in Google Cloud Storage	Gestionar los datos en Google Cloud Storage
Manage your data and permissions in Google Cloud Storage	Administrar los datos y los permisos en Google Cloud Storage
View medal counts and daily recap videos on Google.	Consulta el recuento de medallas y echa un vistazo a los vídeos con resúmenes diarios en Google.
View the full medal counts on Google.	Consulta los recuentos de medallas completos en Google.
Add or modify information	Añadir o cambiar información
Delete failed. Please try again.	No se ha podido eliminar. Inténtalo de nuevo.
You looked up this word	Has buscado esta palabra
You found this helpful.	Esta reseña te ha sido útil.
Your feedback helps others decide which movies to watch.	Tus comentarios ayudan a otros usuarios a decidir qué película ver.
Pollen updates turned off	Notificaciones sobre el nivel de polen desactivadas
Pollen updates turned on	Notificaciones sobre el nivel de polen activadas
Required field cannot be left blank	Los campos obligatorios no se pueden dejar en blanco.
Max games won in a row	Máximo juegos seguidos ganados
Max points won in a row	Máximo puntos seguidos ganados
Update your browser to the latest version.	Instalar la última versión del navegador.
How this change affects older browsers	Cómo afecta este cambio a los navegadores más antiguos
View your data in Google Cloud Storage	Ver tus datos en Google Cloud Storage
This must be an email!	Este campo debe ser un correo electrónico.
Follow teams and leagues to get scores, news and videos	Sigue los equipos y las ligas para tener acceso a los resultados, noticias y vídeos
Visually similar images on the web	Imágenes similares de la Web
Sir William Henry Perkin’s 180th birthday	180 aniversario del nacimiento de sir William Henry Perkin
Shigeru Mizuki’s 96th birthday	96 aniversario del nacimiento de Shigeru Mizuki
Mario Pani’s 107th birthday	107 aniversario del nacimiento de Mario Pani
Katsuko Saruhashi’s 98th birthday	98 aniversario del nacimiento de Katsuko Saruhashi
Gabriel Garcia Marquez’s 91st birthday	91 aniversario del nacimiento de Gabriel García Márquez
Guillermo Haro’s 105th birthday	105 aniversario del nacimiento de Guillermo Haro
Farooq Sheikh’s 70th birthday	70 aniversario del nacimiento de Farooq Sheikh
45th Anniversary of the Chipko Movement	45 aniversario del movimiento Chipko
No rooms available for easy booking for the selected dates.	No hay habitaciones disponibles que se puedan reservar fácilmente para las fechas seleccionadas.
There was a problem loading the next round of questions	No se ha podido cargar la siguiente ronda de preguntas
Some exam dates may be optional, confirm your required dates when you register	Puede que algunas fechas de examen sean opcionales; confirma las fechas obligatorias al registrarte
New! Get updates about your favorite teams	¡Nuevo! Recibe notificaciones sobre tus equipos favoritos
Report an inappropriate image	Informar sobre una imagen inadecuada
More dates and showtimes	Más fechas y pases
Get alerts for this search	Recibe alertas de esta búsqueda
Manage your basic mail settings	Gestiona la configuración básica de tu correo
Manage your Google Kids Hub creations and app-specific settings	Gestionar tus creaciones de Google Kids Hub y la configuración específica de la aplicación
Must be a whole number.	Debe ser un número entero.
Switch account to vote	Cambia de cuenta para votar
What word do you want to define?	¿Qué palabra quieres definir?
View all on Google	Verlas todas en Google
Is this a known landmark for finding places nearby?	¿Este lugar es un punto de referencia para encontrarsitioscercanos?
Click to see places matching this title nearby.	Haz clic para versitioscercanos que coincidan con este título.
Add your favorite teams to see the latest scores, news, and videos.	Añade tus equipos favoritos para ver los últimos resultados, noticias y vídeos.
Share details of your own experience at this place	Comparte detalles de tu experiencia en este lugar
These items will be permanently deleted from your Google Account.	Estos elementos se eliminarán permanentemente de tu cuenta de Google.
Search within a range of numbers	Limitar la búsqueda a un intervalo de números
Search for related sites	Buscar sitios web relacionados
You can use symbols or words in your search to make your search results more precise.	Si quieres obtener unos resultados más precisos, incluye símbolos o palabras en la búsqueda.
Add your favorite teams and leagues to see the latest scores, news and videos	Añade tus ligas y equipos favoritos para ver los últimos resultados, noticias y vídeos
Promote your business with an ad on Google	Anunciar tu empresa en Google
Search for a specific site	Buscar en un sitio concreto
Second serve points won	Segundo saque: puntos ganados
First serve points won	Primer saque: puntos ganados
Some review summaries provided by TrustYou. Unattributed quotes are from reviews made on Google.	Algunos resúmenes de reseñas proporcionados por TrustYou. Las citas sin atribuir provienen de reseñas realizadas en Google.
Get the latest news, videos, and scores for your favorite teams in one place	Recibe las noticias, los vídeos y los resultados más recientes de tus equipos favoritos en un único lugar
What's the emergency number?	¿Cuál es el número de emergencias?
Star and save places to quickly find them again later.	Destaca y guarda sitios para encontrarlos rápidamente más tarde.
Near the city center; sightseeing nearby	Cerca del centro de la ciudad; sitios de interés en las proximidades
Find businesses, addresses and places of interest.	Localiza empresas, direcciones y sitios de interés.
Sign in to access, organize and share your places	Inicia sesión para acceder, organizar y compartir tus sitios.
Click to see places nearby.	Haz clic para ver sitios cercanos.
Near the beach; sightseeing nearby	Cerca de la playa; sitios de interés en las proximidades
No borders, labels, places or roads.	Sin fronteras, etiquetas, sitios ni carreteras.
From your contacts and places	De tus contactos y sitios
Perform personalized map searches and view your saved places	Realizar búsquedas de mapas personalizados y ver los sitios guardados
Send places right to your device	Enviar sitios directamente a tu dispositivo
Or drag an image here	O arrastrar la imagen aquí
Own this business? Reply to reviews	¿Eres el propietario de esta empresa? Responde a reseñas
Own this business? Attract more customers	¿Eres el propietario de esta empresa? Atrae a más clientes
Your business on Google	Tu empresa en Google
Own this business? Start posting on Google	¿Eres el propietario de esta empresa? Empieza a publicar contenido en Google
Add or edit your business	Añadir o modificar empresas
Own this business? Manage your business information	¿Eres el propietario de esta empresa? Gestiona la información relacionada con ella
Top to-dos for your business	Principales tareas pendientes de tu empresa
Click an area below to edit	Haz clic en un área a continuación para editarla
Own this business? Make it stand out	¿Eres el propietario de esta empresa? Haz que destaque
Tap an area below to edit	Toca un área a continuación para editarla
Google may contact you about the status of your suggestion.	Google puede ponerse en contacto contigo para comunicarte el estado de tu sugerencia.
Useful phrases in the local language	Frases útiles en el idioma local
Looks like the list of available rooms has changed. Please select a different room.	Parece que la lista de habitaciones disponibles ha cambiado. Selecciona otra habitación.
What is shown in this image?	¿Qué aparece en esta imagen?
Library removed from favorites	Se ha eliminado la biblioteca de los favoritos
Based on local employers	En las empresas de la zona
Library saved as a favorite	Se ha guardado la biblioteca como favorito
Typical pay for this type of work	Remuneración habitual por este tipo de trabajo
Please do not submit any personal information	No envíes información personal.
Your question will not be submitted.	No se enviará tu pregunta.
Can’t find what you’re looking for?	¿No has encontrado lo que buscabas?
We’re showing these places based on your browsing activity and recent searches on Google.	Te mostramos estos sitios en función de tu actividad de navegación y tus búsquedas recientes en Google.
Learn more about managing your search activity	Más información sobre cómo gestionar tu actividad de búsqueda
Your Internet speed is very fast	Tu velocidad de Internet es muy rápida
Learn who can see your activity	Información sobre quién puede ver tu actividad
Payom Sinawat’s 109th birthday	109 aniversario del nacimiento de Payom Sinawat
Paula Modersohn-Becker’s 142nd birthday	142 aniversario del nacimiento de Paula Modersohn-Becker
Borders, labels, places and roads.	Fronteras, etiquetas, sitios y carreteras.
Star your favorite places on Google Maps	Destaca tus sitios favoritos en Google Maps
What is wrong with this?	¿Cuál es el problema?
This photo is irrelevant to this business	Esta foto no es relevante para este negocio
Google Trends fun facts	Curiosidades de Google Trends
Access Support Trends data	Acceder a los datos de Support Trends
Sergei Eisenstein’s 120th birthday	120 aniversario del nacimiento de Sergei Eisenstein
Room availability not known. Contact the hotel or try different dates.	No hay información sobre la disponibilidad de habitaciones. Ponte en contacto con el hotel o prueba con otras fechas.
View and manage your use of Googler perks in Bookit	Ver y administrar tu uso de los beneficios de Googlers en Bookit
You can see how long it might take to get to a job from home.	Puedes ver cuánto tiempo tardarías en ir de tu casa a los lugares de trabajo.
Choose a radius or a city.	Elige un radio o una ciudad.
Why we sell advertising, not search results	Por qué vendemos publicidad y no resultados de búsqueda
Search results from your Google products	Resultados de búsqueda de tus productos de Google
Google partners are businesses which have a commercial relationship with Google.	Los colaboradores de Google son empresas que tienen una relación comercial con Google.
See how many places your answers have helped	Mira todos los sitios que has ayudado a mejorar con tus respuestas
Create your own maps to share the places that matter to you.	Crea tus propios mapas para compartir los sitios que más te importan.
Your contribution helps everyone make better decisions about places to go.	Tu contribución ayuda a los demás a tomar decisiones más acertadas sobre los sitios que pueden visitar.
View and manage your Google Play Android Developer account	Le permite ver y administrar su cuenta de desarrollador de Android de Google Play.
View and manage your App Indexing data	Ver y administrar tus datos de App Indexing
Best practices and new features	Prácticas recomendadas y funciones nuevas
These are from your Google Feed	De tu tablón de Google
This link cannot be tested.	Este enlace no se puede probar.
The image you are trying to drag has been blocked by the hosting site.	El sitio web en que se aloja la imagen que estás intentando arrastrar la ha bloqueado.
Please hover over each cell for the character name.	Coloca el cursor sobre cada celda para ver el nombre del carácter.
Sports, Celebrations and Activities	Deportes, celebraciones y actividades
Transport, Maps and Signage	Transporte, mapas y señales
Animals, Plants and Food	Animales, plantas y comida
Weather, Scenes and Zodiac signs	Tiempo y signos del zodíaco
The related flight is behind schedule. View status of	Un vuelo de código compartido se ha retrasado. Ver el estado de
To see stocks you are following, please refresh the page.	Para ver las acciones que estás siguiendo, actualiza la página.
View web pages cached in Google Search Results	Ver páginas web en caché en los resultados de la Búsqueda de Google
These pages then become part of Google’s cache.	Las páginas almacenadas pasan así a formar parte de la caché de Google.
Social profiles include a YouTube channel, Google+ page, Facebook page, Twitter handle, and Instagram account.	Entre los perfiles de redes sociales se incluyen los canales de YouTube, las páginas de Google+, Facebook y Twitter, y las cuentas de Instagram.
Only the current owner can transfer ownership to a new owner.	El propietario actual es el único que puede transferir la propiedad a un nuevo propietario.
Add social profiles to a Knowledge Graph card	Añadir perfiles de redes sociales a una tarjeta de gráfico de conocimiento
Search for your topic on Google and find its Knowledge Graph card.	Busca el tema en Google de manera que aparezca la tarjeta de gráfico de conocimiento.
Search console helps you manage your site’s presence in Google search results.	Con Search Console puedes gestionar la presencia de tu sitio web en los resultados de búsqueda de Google.
At the top right, select your profile image and see if you’re signed in as the owner.	En la parte superior derecha, selecciona tu imagen de perfil y comprueba si has iniciado sesión como dicho propietario.
Suggest a change to a Knowledge Graph card	Sugerir un cambio en una tarjeta de gráfico de conocimiento
When you change this setting, it will change the language of all apps on your phone.	Al hacerlo, se cambiará el idioma de todas las aplicaciones que tiene instaladas.
Rukhmabai Raut’s 153rd Birthday	153.º aniverario del nacimiento de Rukhmabai Raut
Removed from visited places	Se ha retirado de los sitios visitados
Added to visited places	Se ha añadido a los sitios visitados
Clear your filters to turn on price tracking	Quita los filtros para activar el seguimiento de precios
Structured Data Testing Tool	Herramienta de pruebas de datos estructurados
Details and tips for suggesting changes	Detalles y consejos para sugerir cambios
Mihajlo Pupin's 153th Birthday	153.º aniverario del nacimiento de Mihajlo Pupin
Rakhmabai Raut’s 153rd Birthday	153.º aniverario del nacimiento de Rakhmabai Raut
Top movers in your portfolios	Mayores variaciones de tus carteras
How Google determines whether a document is a fact check	Cómo determina Google si un documento es contenido de verificación de datos
See fact checks in search results	Ver verificaciones de datos en los resultados de búsqueda
How can a publisher add information to a Knowledge Panel?	¿Cómo puede añadir datos un editor a un panel de información?
Publishers cannot opt-out from having a Knowledge Panel.	Los editores no pueden inhabilitar los paneles de información.
What info shows up	Qué información se muestra
Keep in mind that Google does not endorse any of these fact checks.	Ten en cuenta que Google no se responsabiliza de las verificaciones de datos.
How Google determines a fact check	Cómo detecta Google una verificación de datos
Report spam or abuse	Marcar como spam o uso inadecuado
Disagree with a fact check	Desacuerdo con una verificación de datos
What fact checks look like	Cómo son las verificaciones de datos
Browse top sights, flights, hotels, and more	Descubrir los principales sitios, vuelos, hoteles y mucho más
Tap to add to your events	Toca para añadirlo a tus eventos
Clear filters for more results.	Para obtener más resultados, elimina los filtros.
See web results for more results.	Para obtener más resultados, usa la búsqueda web.
Added to your events	Se ha añadido a tus eventos
Not a match. Here are businesses that can help.	No coincide. Te mostramos las empresas que pueden ayudarte.
Note: Not all providers offer all services.	Nota: No todos los proveedores ofrecen todos los servicios.
Why these sponsored results?	¿Por qué se muestran estos anuncios?
View and manage user data for your loyalty program	Permite visualizar y administrar los datos del usuario del programa de fidelización.
Children, elders and those with breathing or heart problems should reduce outdoor activities.	Los niños, los ancianos y las personas que sufren problemas respiratorios o coronarios deberían reducir la práctica de actividades en el exterior.
Those who are unusually sensitive to air pollution may experience discomfort.	Las personas a las que no les suele afectar la contaminación atmosférica pueden tener dificultades para respirar.
Avoid long or intense outdoor activities and exercise.	Se debe evitar la práctica intensa o prolongada de ejercicio y de actividades en el exterior.
Reduce long or intense outdoor activities.	Se debe reducir la práctica intensa o prolongada de actividades en el exterior.
Avoid all outdoor activities.	Se debe evitar la práctica de actividades en el exterior.
Children, elders, and weak or sick people should reduce long or intense outdoor activities.	Los niños, los ancianos y las personas débiles o enfermas deberían reducir la práctica intensa o prolongada de actividades en el exterior.
Avoid long or intense outdoor activities.	Se debe evitar la práctica intensa o prolongada de actividades en el exterior.
People with breathing or heart problems may experience breathing discomfort.	Es posible que las personas que sufren problemas respiratorios o coronarios tengan dificultades para respirar.
People with breathing or heart problems should reduce long or intense outdoor activities.	Las personas que sufren problemas respiratorios o coronarios deberían reducir la práctica intensa o prolongada de actividades en el exterior.
Children, elders and those with breathing or heart problems should reduce outdoor exercise.	Los niños, los ancianos y las personas que sufren problemas respiratorios o coronarios deberían reducir la práctica de ejercicio en el exterior.
Just a few more steps to find more customers.	Solo te quedan unos pasos para encontrar más clientes.
Select options to add votes, then submit.	Selecciona opciones para añadir votos y, a continuación, envíalos.
Before you sign in to Twitter, confirm your Google Account	Antes de iniciar sesión en Twitter, confirma tu cuenta de Google
Sign in to your Google Account	Inicia sesión en tu cuenta de Google
You have submitted all your votes	Has enviado todos tus votos
Private, inappropriate, or duplicate places	Sitios privados, inapropiados o duplicados
Name, address, category, hours, etc.	Nombre, dirección, categoría, horario, etc.
Ready to request with Google Wallet	Listo para enviar la solicitud con Google Wallet
Ready to send with Google Wallet	Listo para hacer el envío con Google Wallet
The home address you added to your Google account	La dirección de casa que indicaste en tu cuenta de Google
Wilder Penfield’s 127th birthday	127 aniversario del nacimiento de Wilder Penfield
Wilhelm Bartelmann’s 172nd Birthday	172 aniversario del nacimiento de Wilhelm Bartelmann
Zhou Youguang’s 112th birthday	112 aniversario del nacimiento de Zhou Youguang
Stephen Keshi’s 56th birthday	56 aniversario del nacimiento de Stephen Keshi
Teresa Teng’s 65th birthday	65 aniversario del nacimiento de Teresa Teng
Virginia Woolf’s 136th birthday	136 aniversario del nacimiento de Virginia Woolf
Sitara Devi’s 97th Birthday	97 aniversario del nacimiento de Sitara Devi
Sor Juana Inés de la Cruz’s 366th Birthday	366 aniversario del nacimiento de sor Juana Inés de la Cruz
Max Born’s 135th Birthday	135 aniversario del nacimiento de Max Born
Nelly Sachs’ 126th Birthday	126 aniversario del nacimiento de Nelly Sachs
Nain Singh Rawat’s 187th Birthday	187 aniversario del nacimiento de Nain Singh Rawat
Mohammed Rafi’s 93th Birthday	93 aniversario del nacimiento de Mohammed Rafi
Meret Oppenheim’s 104th Birthday	104 aniversario del nacimiento de Meret Oppenheim
Nellie Campobello’s 117th Birthday	117 aniversario del nacimiento de Nellie Campobello
Machiko Hasegawa’s 98th birthday	98 aniversario del nacimiento de Machiko Hasegawa
Maria Lenk’s 103rd birthday	103 aniversario del nacimiento de Maria Lenk
Kuppali Venkatappa Puttappa’s 113th Birthday	113 aniversario del nacimiento de Kuppali Venkatappa Puttappa
José Clemente Orozco’s 134th Birthday	134 aniversario del nacimiento de José Clemente Orozco
Mahasweta Devi’s 92nd Birthday	92 aniversario del nacimiento de Mahasweta Devi
Katy Jurado’s 94th Birthday	94 aniversario del nacimiento de Katy Jurado
Jackie Forster’s 91st Birthday	91 aniversario del nacimiento de Jackie Forster
Gertrude Jekyll’s 174th Birthday	174 aniversario del nacimiento de Gertrude Jekyll
Cornelia Sorabji’s 151st Birthday	151 aniversario del nacimiento de Cornelia Sorabji
Clare Hollingworth’s 106th Birthday	106 aniversario del nacimiento de Clare Hollingworth
Farouk Shousha’s 82nd birthday	82 aniversario del nacimiento de Farouk Shousha
Clärenore Stinnes’s 117th birthday	117 aniversario del nacimiento de Clärenore Stinnes
Begum Akhtar’s 103rd Birthday	103 aniversario del nacimiento de Begum Akhtar
25th Anniversary of Rafflesia Arnoldii	25 aniversario de Rafflesia Arnoldii como flor nacional de Indonesia
Based on your saved places	Basado en tus sitios guardados
News, soundtrack, reviews and more	Noticias, banda sonora, reseñas y mucho más
Save your customers the trouble of checking your holiday hours	Haz que tus clientes puedan ver fácilmente tu horario de días festivos
Choose a focus for your next trip	Elegir en qué se centrará tu próximo viaje
Browse trips based on your location	Explorar viajes según tu ubicación
Could not load reviews	No se han podido cargar las reseñas
Share your recent searches, favorites and more?	¿Quieres compartir tus búsquedas recientes, tus favoritos y mucho más?
Hirotugu Akaike’s 90th Birthday	90 aniversario del nacimiento de Hirotugu Akaike
Brands you might like	Marcas que podrían gustarte
By animal contact or injury.	Por el contacto con un animal o una herida producida por un animal.
Game info will be available soon	La información del partido estará disponible en breve
From: apps-help@google.com	De: apps-help@google.com
We are always working to make the app faster and more stable.	Nuestro objetivo siempre es hacer que la aplicación sea más rápida y estable.
Turn on the feed for a work or school account	Activar el tablón en una cuenta del trabajo o de un centro educativo
We will email you when the archive is ready to download.	Te enviaremos un correo electrónico cuando puedas descargar el archivo.
Change how your keyboard works	Cambiar el funcionamiento del teclado
Change your keyboard vibration, sound, or theme	Cambiar la vibración, el sonido o el tema del teclado
Enter your search in the box above	Introduce tu búsqueda en el campo de arriba
What can’t be changed	Elementos que no se pueden cambiar
Here are some tips for suggesting an image:	A continuación, te ofrecemos algunos consejos para sugerir una imagen:
Turn on notifications about high pollen?	¿Quieres activar las notificaciones sobre nivel de polen alto?
Get real-time notifications about the stuff most important to you.	Recibe notificaciones en tiempo real sobre los temas que más te interesen
Get instant notifications about the stuff most important to you.	Recibe notificaciones instantáneas sobre los temas que más te interesen
When you have Now card history, you help Google provide you more useful cards and notifications	Con el historial de tarjetas Now, contribuirás a que Google te proporcione notificaciones y tarjetas más útiles
There was an error loading notifications.	Se ha producido un error al cargar las notificaciones.
Turn on Olympics notifications	Activa las notificaciones sobre los Juegos Olímpicos
View and manage your Chrome apps notifications	Consultar y administrar las notificaciones de sus aplicaciones de Chrome
Please confirm your acceptance by checking this box.	Selecciona esta casilla para confirmar que aceptas las condiciones.
View and manage your knols and redirect URLs	Consulte y administre las URL de redirección de sus knoles.
View and manage your interest-based notifications	Permite ver y administrar sus notificaciones basadas en intereses.
View and manage notifications received on your domain	Permite ver y administrar las notificaciones que se reciben en tu dominio.
How Google uses the image you search with	Cómo utiliza Google la imagen con la que se hace la búsqueda
Right-click any image you see on a website or in search results.	Haz clic con el botón derecho en cualquier imagen que aparezca en un sitio web o en los resultados de búsqueda.
Check tracked prices and manage email notification settings	Consultar los precios con seguimiento y gestionar la configuración de las notificaciones por correo electrónico
Send Trusted Service Manager notification messages to Google Wallet	Permite enviar mensajes de notificación de Trusted Service Manager a Google Wallet
Send issuer notification messages to Google Wallet	Permite enviar mensajes de notificación del emisor a Google Wallet
A new tab will open with your results.	Se abrirá una nueva pestaña con los resultados de la búsqueda.
Celebrating the Studio for Electronic Music	Celebración de la creación del estudio de música electrónica
Rakhmabai Raut’s 153rd birthday	153 aniversario del nacimiento de Rakhmabai Raut
More details and reviews	Más detalles y reseñas
Get your free website	Crea tu sitio web gratis
Your free website is waiting for you. Preview, edit, and publish in minutes.	Tu sitio web, rápido y gratis. Mira la vista previa, haz tus ajustes y publícalo.
You recently viewed this item	Has visto este producto recientemente
Businesses with a website grow faster than those without	Las empresas que tienen un sitio web obtienen más beneficios que las que no lo tienen
Follow the lowest rates and receive price alerts and tips by email	Seguir los precios más económicos, y recibir alertas de precios y consejos por correo electrónico
Places that may not match all filters	Sitios que quizás no coincidan con todos los filtros
Available from your favorite libraries	Disponible en tus bibliotecas preferidas
Destination based on your previous searches	Destino según tus búsquedas anteriores
Show ads from this advertiser	Mostrar anuncios de este anunciante
Error taking photo. Please try again.	No se ha podido hacer la foto. Inténtalo de nuevo.
So your videos will have sound	Para que los vídeos tengan sonido
Enable your microphone to record your video with sound.	Habilita el micrófono para grabar con sonido.
So you can capture photos and videos	Para que puedas hacer fotos y vídeos
Touch and hold the image.	Mantén pulsada la imagen.
A description for this result is not available because of this site's robots.txt	Este resultado carece de descripción debido al archivo robots.txt de este sitio
Help improve Google Now Launcher	Contribuir a la mejora de Google Now Launcher
To turn this setting on or off:	Para desactivar dicha función, sigue estos pasos:
Touch and hold a widget.	Mantén pulsado un widget.
Touch and hold any empty spot of a Home screen.	Mantén pulsado un punto vacío de una pantalla de inicio.
After you install the Google Now Launcher, there are a few settings you can customize on your phone or tablet.	Después de instalar Google Now Launcher, puedes personalizar algunos ajustes en tu teléfono o tablet.
Add apps to a Home screen	Añadir aplicaciones a una pantalla de inicio
Touch and hold an app.	Mantén pulsada una aplicación.
Add widgets to a Home screen	Añadir widgets a una pantalla de inicio
Google is stuck as my homepage	Google es mi página principal y no puedo cambiarla
You can quickly get to Google every time you open your browser by making Google your homepage.	Para acceder rápidamente a Google cada vez que abras el navegador, puedes convertir Google en tu página principal.
Make Google your homepage	Convertir Google en la página principal
Choose a browser below, then follow the steps on your computer.	Elige un navegador a continuación y sigue los pasos que se indican en tu ordenador.
To remove an app from search results, uncheck the box.	Para eliminar una aplicación de los resultados de búsqueda, desmarca la casilla correspondiente.
To include an app in search results, check the box.	Para incluir una aplicación en los resultados de búsqueda, marca la casilla correspondiente.
Veronika Dudarova’s 101st Birthday	101.º aniversario del nacimiento de Veronika Dudarova
Nelly Sachs’s 126th birthday	126.º aniversario del nacimiento de Nelly Sachs
Ratiba El-Hefny’s 86th Birthday	86.º aniversario del nacimiento de Ratiba El-Hefny
Mohammed Rafi’s 93th birthday	93.º aniversario del nacimiento de Mohammed Rafi
Mirza Ghalib’s 220th Birthday	220.º aniversario del nacimiento de Mirza Ghalib
Max Born’s 135th birthday	135.º aniversario del nacimiento de Max Born
Christian Doppler’s 214th Birthday	214.º aniversario del nacimiento de Christian Doppler
Jan Ingenhousz’s 287th Birthday	287.º aniversario del nacimiento de Jan Ingenhousz
Marlene Dietrich’s 116th birthday	116.º aniversario del nacimiento de Marlene Dietrich
Kuppali Venkatappa Puttappa’’s 113th birthday	113.º aniversario del nacimiento de Kuppali Venkatappa Puttappa
Begum Rokeya’s 137th Birthday	137.º aniversario del nacimiento de Begum Rokeya
Did you like this game?	¿Te ha gustado este juego?
Did you like this book?	¿Te ha gustado este libro?
Did you like this album?	¿Te ha gustado este álbum?
Did you like this movie?	¿Te ha gustado esta película?
Did you like this video game?	¿Te ha gustado este videojuego?
Not usually busy at this time	Normalmente poco ajetreado a esta hora
Usually not busy at this time	Normalmente poco ajetreado a esta hora
Usually quiet at this time	Normalmente tranquilo a esta hora
Usually more popular at this time	Normalmente más popular a esta hora
Use your camera to record and share your own GIFs	Usa tu cámara para crear y compartir tus propios GIF
Drag the widget onto your Home screen, then lift your finger.	Arrastra el widget a la pantalla de inicio y, a continuación, levanta el dedo.
View your Google Cloud Platform management resources and deployment status information	Permite visualizar los recursos de administración y la información de estado de implementación de Google Cloud Platform.
View your Google Cloud Platform billing accounts	Permite visualizar tus cuentas de facturación de Google Cloud Platform.
View your Cloud Platform configuration policies and definitions	Ver tus definiciones y políticas de configuración de Cloud Platform
View your data across Google Cloud Platform services	Ver tus datos en los servicios de Google Cloud Platform
When this box is checked, you can control whether activity from your device is saved.	Al marcar esta casilla, puedes controlar si se guarda o no la actividad de tu dispositivo.
Websites and apps you use	Sitios web y aplicaciones que utilizas
Your activity on websites and in apps that use Google services	Tu actividad en los sitios web y las aplicaciones que utilizan servicios de Google
If unwanted programs still change your settings, follow the steps below to reset them.	Si los programas no deseados continúan cambiando tu configuración, sigue estos pasos para restablecerla.
This tool searches your computer for suspicious programs and offers to remove them for you.	Esta herramienta busca en tu ordenador programas sospechosos y te ofrece la oportunidad de eliminarlos.
Sea level is typically warm.	Por lo general, las zonas situadas a la altura del nivel del marzo son cálidas.
Dec–May is warm.	De diciembre a mayo, el tiempo es cálido.
Ski season is Dec–Mar.	La temporada de esquí va de diciembre a marzo.
The mountains are semi-arid, with cold nights and snowcapped peaks.	Las montañas son semiáridas, con noches frías y cumbres nevadas.
Jul–Aug is hot.	Los meses de julio y agosto son calurosos.
The coast has a desert climate.	La costa tiene un clima desértico.
Nov–Mar is the dry season.	y la seca, de noviembre a marzo.
Areas range from the arid coast to glacier-covered mountains.	Las regiones varían de una costa árida a montañas cubiertas por glaciares.
Inland, the Apennine Mountains are cooler.	En el interior, los montes Apeninos son más frescos.
May–Sep is warm to hot.	De mayo a septiembre, el tiempo varía de cálido a caluroso.
The mountains are cold, snowy and peak ski season Nov–Mar.	De noviembre a marzo, las montañas son frías y nevosas, coincidiendo con la temporada de esquí.
Snow can fall in the mountains.	Puede nevar en las montañas.
May–Sep is warm in low-lying areas.	De mayo a septiembre, el tiempo es cálido en las tierras bajas.
Temperatures range from mild during the day to below freezing at night.	Durante el día, el ambiente es templado. Por la noche, hiela.
The lowlands are hot and humid.	En las tierras bajas, los días son calurosos y húmedos.
Extreme heat hits the coast Jun–Sep.	De junio a septiembre, la costa es extremadamente calurosa.
Weather varies by region.	El tiempo varía según la región.
Corsica has a typical Mediterranean climate.	Córcega tiene un clima mediterráneo típico.
The central highlands are hot.	Las zonas montañosas centrales son calurosas.
Aug is typhoon season.	La temporada de tifones es en agosto.
Nov–Feb is cool.	De noviembre a febrero, el tiempo es fresco.
Torrential rains fall in the tropical north Dec–Mar.	El norte es tropical y se caracteriza por lluvias torrenciales que caen entre diciembre y marzo.
The south is subtropical.	El sur es subtropical
The southwest is temperate to Mediterranean.	El clima del suroeste varía de templado a mediterráneo.
Mar–Jun is rainy.	y lluvioso de marzo a junio.
The north is tropical.	El norte es tropical.
May–Oct is hot.	El tiempo es caluroso de mayo a octubre,
Jun–Aug is rainy.	Llueve de junio a agosto.
The climate varies by region and terrain, but is primarily desertlike.	El clima varía en función de la región y el terreno, pero es fundamentalmente de tipo desértico.
The climate varies from temperate to alpine.	El clima varía de templado a alpino.
Nov–Feb is cooler and rainier.	De noviembre a febrero, el tiempo es más fresco y lluvioso.
Climate varies by region.	El clima varía según la región.
Jun–Sep is very hot in the capital and on the coast.	De junio a septiembre, hace mucho calor en la capital y en la costa.
Mar–May and Sep–Nov have warm days and cool nights.	De marzo a mayo y de septiembre a noviembre, los días son cálidos y las noches, frescas.
Dec–Mar is hot by day and breezy at night.	De diciembre a marzo, los días son calurosos y las noches tienen brisa.
Nov–Dec and Mar–Apr are warm, clear and peak travel.	De noviembre a diciembre y de marzo a abril, los días son cálidos y los cielos están despejados.
The rainy season is May–Nov.	La estación lluviosa va de mayo a noviembre.
The tropical weather is warm and dry Dec–Apr, peak travel time.	El clima es tropical. De diciembre a abril, el ambiente es cálido y seco, coincidiendo con la temporada alta.
The tropical climate is consistently warm.	El clima es tropical, por lo que el tiempo es cálido todo el año.
Peak travel is May–Sep.	La temporada alta va de mayo a septiembre.
Peak travel is Dec–Aug.	La temporada alta va de diciembre a agosto.
May–Sep is warmest and peak travel time.	Los meses de mayo a septiembre son los más cálidos, y coinciden con la temporada alta.
The canyon floor is very hot May–Sep. Dec–Mar is cold and snowy.	En la base del cañón, hace mucho calor entre mayo y septiembre. De diciembre a marzo, hace frío y nieva.
Rainy season is May–Nov. Peak travel is Nov–Dec and May.	La estación lluviosa es de mayo a noviembre y la temporada alta, de diciembre a enero.
Weather can change rapidly and vary by area.	El tiempo puede cambiar rápidamente y variar según la zona.
Desert areas are much cooler Dec–Feb.	Las zonas desérticas son mucho más frescas de diciembre a febrero.
Peak travel is Jan–Apr.	La temporada alta va de enero a abril.
Climate varies widely by area.	El clima varía mucho según la región.
Peak travel is May–Aug.	La temporada alta va de mayo a agosto.
Peak travel is Mar–Sep.	La temporada alta va de marzo a septiembre.
Peak travel is Mar–Jun.	La temporada alta va de marzo a junio.
Weather varies by area.	El tiempo varía según la zona.
Orlando has consistently warm, sunny weather.	En Orlando, el tiempo es soleado y cálido todo el año.
Dec–May is warm, dry and peak travel.	Los meses de diciembre a mayo son cálidos y secos, época que coincide con la temporada alta.
Temperatures range from warm to cool Jun–Oct, peak travel season.	Los meses de junio a octubre varían de cálidos a frescos, y coinciden con la temporada alta.
There’s a higher chance of rain Jun–Oct.	Hay una mayor probabilidad de lluvia entre junio y octubre.
Peak travel is May–Jun.	La temporada alta va de mayo a junio.
The climate varies slightly by region, with the north warmer than the south.	El clima varía ligeramente según la región; el norte es más cálido que el sur.
Peak ski season is typically Jan–Mar.	La temporada de esquí suele ser entre enero y marzo.
Teperatures are mild to warm May–Aug, peak travel season.	Entre mayo y agosto, el tiempo varía de templado a cálido, coincidiendo con la temporada alta.
May–Aug is warm and dry.	De mayo a agosto, el ambiente es cálido y seco.
Jun–Sep is hot.	De junio a septiembre, hace calor.
Peak travel is Mar–Jul.	La temporada alta es de marzo a julio.
Peak travel is Jun–Aug.	La temporada alta va de junio a agosto.
May–Sep is mild to cool, with frequent rain.	Entre mayo y septiembre, el ambiente varía de templado a fresco, y las lluvias son frecuentes.
Both are peak travel seasons.	Ambas estaciones coinciden con la temporada alta.
Hurricane season is May–Oct.	La temporada de huracanes es de mayo a octubre.
Highland areas are a bit cooler.	Las zonas montañosas son un poco más frescas.
Peak travel is Mar–Jul and Dec.	La temporada alta es de marzo a julio, y en diciembre.
May–Oct is generally warm and humid.	Por lo general, los meses de mayo a octubre son cálidos y húmedos.
Gulf Shores has a warm, humid climate tempered by sea breezes.	Gulf Shores tiene un clima cálido y húmedo, atemperado por las brisas marinas.
May–Aug is hot.	De mayo a agosto, el ambiente es caluroso.
Nov–Mar is cold, with temperatures sometimes dropping below freezing.	De noviembre a marzo, hace frío, en ocasiones con temperaturas bajo cero.
May–Aug is warm and peak travel season.	Los meses de mayo a agosto son cálidos, y coinciden con la temporada alta.
The weather ranges from mild to warm May–Oct, peak travel season.	La temporada alta es de mayo a octubre, cuando el tiempo varía de templado a cálido.
Peak travel is May–Oct.	La temporada alta es de mayo a octubre.
Peak travel season is May–Oct.	La temporada alta es de mayo a octubre.
May–Aug is warm, dry and sunny.	De mayo a agosto, el tiempo es cálido, seco y soleado.
Jul–Aug is hot and humid.	Los meses de julio y agosto son calurosos y húmedos.
May–Jun is warm.	De mayo a junio, el tiempo es cálido.
Corpus Christi has a warm, humid climate.	Corpus Christi tiene un clima cálido y húmedo.
Jul–Aug is very hot.	Los meses de julio y agosto son muy calurosos.
Peak travel is Feb–Jul.	La temporada alta es de febrero a julio.
The snowy ski season is Dec–Mar.	La temporada de esquí es de diciembre a marzo.
Dec–Feb is rainy.	El tiempo es lluvioso de diciembre a febrero.
Mar–May is peak travel.	La temporada alta va de marzo a mayo.
The weather is typically mild, becoming warmest and driest Jun–Sep. Jun can be foggy.	Entre junio y septiembre, el ambiente es templado, con tendencia a cálido y seco. En junio, puede haber niebla.
West Palm Beach has a tropical, sunny climate.	West Palm Beach tiene un clima tropical, muy soleado.
The weather is warm and dry May–Oct, peak travel time.	La temporada alta es de mayo a octubre, cuando el tiempo es cálido y seco.
Dec–Mar is cool to cold.	Los meses de diciembre a marzo varían de frescos a fríos.
Both are peak travel periods.	Ambas estaciones coinciden con la temporada alta.
May–Sep is hot and humid.	De mayo a septiembre, el tiempo es caluroso y húmedo.
Temperatures are generally warm May–Aug, peak travel time.	Los meses de mayo a agosto son cálidos y coinciden con la temporada alta.
Dec–Apr is very cold.	De diciembre a abril, hace mucho frío.
May–Aug is warm, with occasional rainstorms.	De mayo a agosto, el tiempo es cálido, con tormentas ocasionales.
The climate varies by region.	El clima varía según la región.
Thunderstorms, tornadoes and hurricanes can occur in certain areas at different times.	En algunas zonas, puede haber tormentas, tornados y huracanes en diferentes momentos.
Peak travel is Mar–Aug.	La temporada alta es de marzo a agosto.
Nov–Apr is cool and rainy.	De noviembre a abril, el tiempo es fresco y lluvioso.
Peak travel is Dec–Jan, Mar–May and Jul.	La temporada alta es de diciembre a enero, de marzo a mayo, y en julio.
May–Sep is peak travel time.	La temporada alta va de mayo a septiembre.
Nottingham is often rainy.	Suele llover en Nottingham.
Nov–Dec is cool.	De noviembre a diciembre, es fresco.
May–Aug is mild to warm.	De mayo a agosto, el ambiente varía de templado a cálido.
May–Aug is peak travel.	La temporada alta es de mayo a agosto.
Peak travel times are Mar and Nov–Dec.	La temporada alta es en marzo, noviembre y diciembre.
May–Dec is peak travel.	La temporada alta es de mayo a diciembre.
Jun–Oct is peak travel.	La temporada alta es de junio a octubre.
May–Sep is warm.	De mayo a septiembre, el tiempo es cálido.
Dec–Apr is peak travel.	La temporada alta va de diciembre a abril.
Dec–Mar is warm and peak travel time.	De diciembre a marzo, el tiempo es cálido, época que coincide con la temporada alta.
The hot and humid rainy season is May–Nov, with the heaviest rains in Sep.	La estación lluviosa es húmeda y calurosa, y va de mayo a noviembre. Las lluvias más intensas se concentran septiembre.
Rainy season is Sep–Dec.	La estación lluviosa va de septiembre a diciembre.
Nov–Feb is warm, dry and peak travel.	Los meses de noviembre a marzo son cálidos y secos, y coinciden con la temporada alta.
Temperatures rise Mar–May, with a rainy season May–Nov.	De marzo a mayo, las temperaturas son más altas. La estación lluviosa va de mayo a noviembre.
Jul–Aug and Dec–Feb are drier.	Los meses más secos son julio, agosto, diciembre y febrero.
Temperatures vary by region but are typically warm.	El tiempo varía según la región, pero suele ser cálido.
May–Oct is peak travel.	La temporada alta va de mayo a octubre.
Jul–Sep has warm days.	De julio a septiembre, algunos días son cálidos.
May–Nov is peak travel.	La temporada alta es de mayo a noviembre.
The climate ranges from temperate to alpine.	El clima varía de templado a alpino.
The climate ranges from temperate in the south to subarctic in the north.	El clima varía de templado en el sur a subantártico en el norte.
Peak travel is Jul–Aug and Dec–Jan.	La temporada alta es en julio, agosto, diciembre y enero.
Feb–Mar is another popular time to visit.	Febrero y marzo también son meses de temporada alta.
Nights are cool Dec–Apr. The climate is dry, but the northeast is cooler and wetter.	Las noches son frescas de diciembre a abril. El clima es seco, pero el noreste es más fresco y lluvioso.
Mar–Jun is warm, dry and peak travel.	Los meses de marzo a junio son cálidos y secos, y coinciden con la temporada alta.
Palma has a sunny Mediterranean climate.	Palma tiene un clima mediterráneo, muy soleado.
Jun–Jul is hot.	Los meses de junio y julio son calurosos.
Dec–Mar is peak travel at the southern beaches.	La temporada alta en las playas del sur es de diciembre a marzo.
Nov–Feb is hot, balmy and often rainy.	De noviembre a febrero, el tiempo es caluroso y agradable, y llueve a menudo.
May–Sep is dry.	Los meses de mayo a septiembre, son secos.
Port Elizabeth has a subtropical climate with abundant sunshine.	Puerto Elizabeth tiene un clima subtropical con mucho sol.
Peak travel is Mar–May and Nov–Dec.	La temporada alta es de marzo a mayo y de noviembre a diciembre.
May–Oct is dry season.	La estación seca es de mayo a octubre.
Nov–Jun is the dry, warm season.	La estación seca y cálida es de noviembre a junio.
Jul–Oct is the hot, rainy wet season.	La estación lluviosa es calurosa y va de julio a octubre.
The desertlike climate means temperatures are extremely high May–Sep. The weather is warm Nov–Mar.	El clima es desértico, por lo que de mayo a septiembre las temperaturas son extremadamente altas. De noviembre a marzo, el tiempo es cálido.
May–Sep is extremely hot and rarely rainy.	De mayo a septiembre, el tiempo es extremadamente caluroso y muy poco lluvioso.
Nov–Mar is warm.	y de noviembre a marzo son cálidos.
Claimate varies by region.	El clima varía según la región.
May–Sep is extremely hot with almost no rain.	Los meses de mayo a septiembre son extremadamente calurosos, casi sin lluvias.
Jan–Apr are the driest months.	Los meses más secos son de enero a abril.
Jul–Aug is hot, sunny and dry.	En julio y agosto, los días son calurosos, soleados y secos.
Wrocław is warmer than much of Poland.	Breslavia es más cálida que gran parte de Polonia.
Rainfall is highest May–Oct. Dec–May is peak travel time.	Cuando más llueve es de mayo a octubre. La temporada alta va de diciembre a mayo.
Dry season is Nov–Apr.	La estación seca es de noviembre a abril.
Rainy season is May–Oct.	y la estación lluviosa, de mayo a octubre.
Machu Picchu has a highland climate, with warm days and cool nights.	Machu Picchu tiene un clima alpino, con días cálidos y noches frescas.
Dec–Mar is rainy.	El tiempo es lluvioso de diciembre a marzo.
Dec–Apr is wet in some areas.	De diciembre a abril, algunas zonas son lluviosas.
Nov–Mar is rainy.	El tiempo es lluvioso de noviembre a marzo.
Climate varies by region, from tropical to arid.	El clima varía de tropical a árido según la región.
May–Nov often has low, dense cloud cover.	De mayo a noviembre, los cielos suelen estar cubiertos de nubes bajas y densas.
Nov–Apr is warm, with occasional rain.	De noviembre a abril, el tiempo es cálido, con lluvias ocasionales.
Jun–Sep is rainy in the south.	De junio a septiembre, el tiempo es lluvioso en el sur.
Dec–Apr is driest and peak travel time.	Los meses más secos son de diciembre a abril, coincidiendo con la temporada alta.
Nov–Apr is warm, with occasional heavy rains.	De noviembre a abril, el tiempo es cálido, con lluvias intensas ocasionales.
May–Nov is rainy, especially on the Caribbean coast.	De mayo a noviembre, el tiempo es lluvioso, especialmente en la costa caribeña
May–Aug is hot in Muscat and the interior.	De mayo a agosto, es caluroso en Mascate y el interior.
In Lagos and Cross River National Park, rainstorms are frequent May–Oct.	En Lagos y el Parque Nacional del Río Cross, las tormentas son frecuentes de mayo a octubre.
Nov–Mar is cool.	y fresco de noviembre a marzo.
May–Oct is rainy.	Llueve de mayo a octubre.
Rainy season is Mar–Oct, with rainfall peaking Jun–Jul.	La estación lluviosa va de marzo a octubre, con mayor concentración de lluvia en junio y julio.
May–Oct is cool.	El ambiente es fresco de mayo a octubre.
Nov–Apr is warm.	De noviembre a abril, es cálido.
The warmer months of Dec–Apr are peak travel.	La temporada alta abarca los meses más cálidos, de diciembre a abril.
The climate is sunny, dry and often windy.	El tiempo es seco, soleado y, a menudo, ventoso.
May–Oct is the humid monsoon season.	La estación del monzón es húmeda y va de mayo a octubre.
The rainy season is May–Oct.	La estación lluviosa va de mayo a octubre.
Feb–Apr is hot.	Los meses de febrero a abril son calurosos.
Monsoon rains peak Jun–Sep. Peak travel is Dec–May.	La estación del monzón es de junio a septiembre. La temporada alta va de diciembre a mayo.
Nov–May is the dry season.	La estación seca es de noviembre a mayo.
Wet season is Jun–Sep.	La estación lluviosa va de junio a septiembre.
Popular travel periods include Dec–Jan, Apr and Jul–Aug.	La temporada alta es en diciembre, enero, abril, julio y agosto.
Nov–Feb is cooler.	De noviembre a febrero, es más fresco.
Jun–Sep is warm and rainy, with regular thunderstorms.	De junio a septiembre, el tiempo es cálido y lluvioso, con tormentas frecuentes.
Dec–Apr is warm, dry and peak travel time.	De diciembre a abril, el tiempo es cálido y seco, coincidiendo con la temporada alta.
Jun–Sep is mild and rainy.	De junio a septiembre, el tiempo es lluvioso y templado.
Rain is common Jun–Sep.	Las lluvias son frecuentes de junio a septiembre.
Generally, Dec–Apr is warm and dry and Jun–Oct is hot and rainy.	De diciembre a abril, el tiempo suele ser cálido y seco, y de junio a octubre, caluroso y lluvioso.
Feb–Mar and May–Jun are common times to visit, but Dec is the most popular.	Si bien muchos turistas llegan en febrero, marzo, mayo y junio, la temporada alta es en diciembre.
Peak travel is Dec–Feb and Jun–Sep.	La temporada alta es de diciembre a febrero y de junio a septiembre.
A rainy monsoon season varies by region.	La lluviosa estación de monzón varía según la región.
The rainy monsoon season peaks May–Sep. Dry season is Nov–Mar.	La lluviosa estación del monzón va de mayo a septiembre. La estación seca es de noviembre a marzo.
The north can be cold Nov–Feb.	El norte puede ser frío de noviembre a febrero.
Kenya is warm and temperate.	En Kenia, el clima es cálido y templado.
Nairobi is warm and temperate.	En Nairobi, el ambiente es cálido y templado.
Higher altitudes are snowy, cloudy and freezing.	En las zonas de gran altitud, hay nieve, nubes y temperaturas bajo cero.
The climate is generally mild.	El clima es, en general, templado.
Popular travel times are Mar–May, Aug and Nov–Dec.	La temporada alta es de marzo a mayo, agosto y de noviembre a diciembre.
Tokyo has a humid subtropical climate.	En Tokio, el clima es subtropical húmedo.
The north is cold and snowy Dec–Feb.	El norte es frío y nevoso de diciembre a febrero.
Peak travel is Dec–May.	La temporada alta va de diciembre a mayo.
Nov–Mar is mild.	De noviembre a marzo, el ambiente es templado.
Palermo has a sunny Mediterranean climate.	Palermo tiene un clima mediterráneo, con días soleados.
Nov–Mar brings flooding that covers some areas with ankle-deep water.	De noviembre a marzo, en algunas zonas hay inundaciones con agua que cubre hasta los tobillos.
May–Aug is warmest and peak travel time.	Los meses de mayo a agosto son los más cálidos, y coinciden con la temporada alta.
May–Sep is very dry and extremely hot in most areas.	De mayo a septiembre, el tiempo es extremadamente caluroso y muy seco en la mayoría de las zonas.
May–Sep is the least rainy period.	De mayo a septiembre es la época menos lluviosa.
Although it varies by region, Jun–Oct is generally dry.	y varía según la región. De junio a octubre, el tiempo suele ser seco.
Dry season is Jun–Oct. Rain and storms are common Nov–Apr.	La estación seca es de junio a octubre. Las lluvias y tormentas son frecuentes de noviembre a abril.
Dec–Apr has monsoon rains.	De diciembre a abril, hay lluvias monzónicas.
The humid wet season is Jun–Aug, with heavy monsoon rains.	La estación lluviosa es de junio a agosto, con lluvias monzónicas intensas.
The rainy monsoon season is Jun–Sep.	La lluviosa estación del monzón va de junio a septiembre.
Rajasthan has a semi-arid to arid climate.	Rajastán tiene un clima de semiárido a árido.
Jul–Sep is the rainy monsoon season.	La lluviosa estación del monzón va de julio a septiembre.
Monsoon rains in Jun–Aug can be heavy.	Las lluvias monzónicas de junio a agosto pueden ser intensas.
The wet monsoon season is Jun–Sep.	La lluviosa estación del monzón va de junio a septiembre.
Dec–Jan is cool.	Diciembre y enero son meses frescos.
May–Aug is mild to warm by day.	Entre mayo y agosto, el ambiente varía de templado a cálido durante el día.
Jun–Oct is monsoon season.	La estación del monzón es de junio a octubre.
Nov–Mar is dry, with mild days and cool nights.	De noviembre a marzo, el tiempo es seco, con días templados y noches frescas.
Jan–Apr is driest. Monsoon season is May–Sep.	Los meses más secos son de enero a abril. La estación del monzón va de mayo-septiembre.
Mar–Jun is hot, and monsoon season follows.	Hace calor de marzo a junio, justo antes de la estación del monzón.
Nov–Mar has warm days and cool nights.	De noviembre a marzo, algunos días son cálidos y algunas noches, frescas.
Jul–Aug is monsoon season.	La estación del monzón es en julio y agosto.
Mar–May is hot.	Los meses de marzo a mayo son calurosos.
Mar–Jun can be extremely hot and humid.	Los meses de marzo a junio pueden ser extremadamente calurosos y húmedos.
The wet monsoon period is Jul–Sep.	La lluviosa estación del monzón es de julio a septiembre.
May–Oct is wet, with heavy monsoon rains Jun–Aug.	Los meses de mayo a octubre son lluviosos, con lluvias monzónicas intensas entre junio y agosto.
Dec–Apr is very dry and peak travel time.	De diciembre a abril, el tiempo es muy seco, coincidiendo con la temporada alta.
Heavy monsoon rains occur Jun–Sep.	De junio a septiembre, se registran lluvias monzónicas intensas.
Mar–May is very hot.	De marzo a mayo, hace mucho calor.
The driest time is Jan–Mar.	La época más seca es de enero a marzo.
Nov–Mar is dry and mild.	De noviembre a marzo, el ambiente es templado y seco.
May–Nov is the rainy monsoon season.	La lluviosa estación del monzón va de mayo a noviembre.
Peak travel times are Dec–Jan and May–Jun.	La temporada alta va de diciembre a enero y de mayo a junio.
Jun–Oct is the humid, rainy monsoon season.	La lluviosa estación del monzón va de junio a octubre.
Dec–Apr is dry and cool.	De diciembre a abril, el tiempo es fresco y seco.
Mar–Jun is very hot.	Los meses de marzo a junio son muy calurosos.
Mar–May is hot and humid.	De marzo a mayo, es caluroso y húmedo.
Jul–Aug has monsoon rains.	Las lluvias monzónicas son en julio y agosto.
May–Jul and Dec are peak travel.	La temporada alta es de mayo a julio, y en diciembre.
Jan–Jun is the dry season.	La estación seca es de enero a junio,
Dec–Mar is generally dry.	Los meses de diciembre a marzo suelen ser secos.
Dec–Feb is driest.	La época más seca es de diciembre a febrero.
Jun–Sep is the rainy monsoon season.	La lluviosa estación del monzón va de junio a septiembre.
Kochi has a humid tropical climate.	Kochi tiene un clima tropical húmedo.
Torrential monsoon rains are typical Jun–Sep.	Suele haber lluvias monzónicas torrenciales entre junio y septiembre.
Chennai has a hot and humid climate.	Chennai tiene un clima caluroso y húmedo.
Dec–Feb is warm by day and cool at night.	De diciembre a febrero, los días son cálidos y las noches, frescas.
Days are typically warm, and evenings are mild to cool.	Los días suelen ser cálidos y las noches varían de templadas a frescas.
Peak travel is Jun–Aug and Dec.	La temporada alta es de junio a agosto, y en diciembre.
Nov–Feb is dry, with warm days and mild evenings.	Los meses de noviembre a febrero son secos, con días cálidos y noches templadas.
May–Oct is hot, humid and rainy.	Los meses de mayo a octubre son calurosos, húmedos y lluviosos.
Dec–Jan is dry, with warm days and mild evenings.	Los meses de diciembre y enero son secos, con días cálidos y noches templadas.
Jun–Sep is the wet monsoon season.	La lluviosa estación del monzón va de junio a septiembre.
Mumbai is usually hot and humid.	En Bombay, el tiempo suele ser caluroso y húmedo.
Jan–Mar is cold and sometimes snowy.	De enero a marzo, hace frío y, a veces, nieva.
Wet season is May–Oct.	La estación lluviosa va de mayo a octubre.
Dec–Jun is dry.	Los meses de diciembre a junio son secos.
Rhodes has a sunny Mediterranean climate.	El tiempo en Rodas es soleado, por su clima típicamente mediterráneo.
Weather ranges from tropical in the lowlands to temperate in the highlands.	El clima varía de tropical en las tierras bajas, a templado en las zonas montañosas.
Nov–Apr is mild.	Los meses de noviembre a abril son templados.
Coastal areas are humid, while the north is savannalike.	La costa es húmeda, y el norte tiene el clima típico de la sabana.
Nov–Apr is mild to cool.	Durante los meses de noviembre a abril, los días varían de templados a frescos.
Nov–Mar is cold.	De noviembre a marzo, hace frío.
Popular travel times are May–Dec.	La temporada alta va de mayo a diciembre.
Mar–May and Sep–Oct are milder.	De marzo a mayo y de septiembre a octubre, el ambiente es templado.
May–Oct is warm and a popular time to visit.	Los meses de mayo a octubre son cálidos y coinciden con la temporada alta.
Peak travel season is May–Sep.	La temporada alta va de mayo a septiembre.
The typically Mediterranean weather is hot and dry May–Sep, when most visitors arrive.	El clima mediterráneo se caracteriza por un tiempo seco y caluroso durante los meses de mayo a septiembre coincidiendo con la temporada alta.
Other months are mild.	y el resto de los meses son templados.
Most areas are temperate.	La mayoría de las zonas son templadas.
May–Aug is mild and peak travel time in southern and central Finland.	En el sur y el centro de Finlandia, los meses de mayo a agosto son templados, coincidiendo con la temporada alta.
Nov–Mar is cold and snowy.	De noviembre a marzo, el tiempo es frío y nevoso.
Fiji has a humid tropical climate.	Fiyi tiene un clima tropical húmedo.
Most of the country is subarctic.	El clima es, en general, subártico.
May–Aug is mild and peak travel period.	Los meses de mayo a agosto son templados y coinciden con la temporada alta.
Jun–Sep is rainy in most areas.	Los meses de junio a septiembre son lluviosos en la mayoría de las zonas.
The climate ranges from mild in the highlands to very hot in the desert lowlands.	El clima varía de templado en las zonas altas de montaña a muy caluroso en las tierras bajas del desierto.
Tallinn has a seasonal climate.	El tiempo de Tallin varía según la estación del año.
Temperatures soar May–Sep. Dec–Apr is warm, dry and peak travel time.	Las temperaturas se disparan de mayo a septiembre. Los meses de diciembre a abril son cálidos y secos, y coinciden con la temporada alta.
Nov–Mar is dry and warm.	De noviembre a marzo, el tiempo es cálido y seco.
Jun–Sep is very hot.	Los meses de junio a septiembre son muy calurosos,
Nov–Apr is mild, with most rain occuring Dec–Jan.	De noviembre a abril, el ambiente es templado, y las lluvias se suelen concentrar en diciembre y enero.
Peak travel is Jul–Aug.	Julio y agosto son los meses de temporada alta.
May–Sep can be scorching hot and humid.	De mayo a septiembre, los días pueden ser abrasadores y húmedos.
The desert climate is hot with almost no rain.	El clima desértico se caracteriza por días calurosos y escasez de lluvias.
Jun–Aug is peak travel.	La temporada alta va de junio a agosto.
Dec–May is cooler and drier.	Los meses de diciembre a mayo son más frescos y secos.
Jun–Nov is dry season, with highland mists.	La estación seca es de junio a noviembre, y presenta niebla en las alturas.
Denmark has mild to warm weather May–Aug, the peak travel season.	Entre mayo y agosto, el tiempo en Dinamarca varía de templado a cálido, coincidiendo con la temporada alta.
Cyprus has a Mediterranean to subtropical climate.	Chipre tiene un clima que varía de mediterráneo a subtropical.
Dec–Apr is warm and dry.	De diciembre a abril, el tiempo es cálido y seco.
May–Sep is warm during the day, mild in the evening.	De mayo a septiembre, el ambiente es cálido durante el día y templado por la noche.
The coast has a Mediterranean climate.	El clima en la costa es de tipo mediterráneo.
Costa Rica is tropical, with several location-based microclimates.	En Costa Rica, el clima es tropical, y tiene varios microclimas según la zona.
Rainy season varies by region.	La estación lluviosa varía según la región.
Mar–May and Sep–Nov are the wettest times.	Los meses más lluviosos son de marzo a mayo y de septiembre a noviembre.
Dec–Apr is driest, making it peak travel time.	Los meses de diciembre a abril son los más secos, y coinciden con la temporada alta.
Rainfall peaks Sep–Oct.	Las lluvias suelen concentrarse en los meses de septiembre y octubre.
Peak travel is Dec–Apr.	La temporada alta va de diciembre a abril.
May–Oct is the rainy monsoon season in the south.	En el sur, la lluviosa estación del monzón va de mayo a octubre.
Typhoon season is Jul–Sep.	La temporada de tifones va de julio a septiembre.
The coast is milder.	y en la costa, más templado.
The north is very dry and hot.	En el norte, es muy seco y caluroso,
Southern Chile and Patagonia are cold Jun–Sep.	En el sur de Chile y la Patagonia, el tiempo es frío de junio a septiembre.
Grand Cayman has a tropical climate.	Gran Caimán tiene un clima tropical.
The northernmost part is sub-arctic.	En las zonas más al norte, el clima es subártico.
Whistler is often rainy.	En Whistler, las lluvias son frecuentes.
Peak trvel times are May–Aug and Dec.	La temporada alta es de mayo a agosto, y en diciembre.
Jun–Aug is warmest and peak travel.	Los meses de junio a agosto son los más cálidos del año, época que coinciden con la temporada alta.
Jun–Sep is the warmest time.	La época más cálida del año es de junio a septiembre.
Jun–Sep is warm and humid.	El tiempo es cálido y húmedo de junio a septiembre.
Rainy season is Jun–Oct.	La estación lluviosa va de junio a octubre.
Hurricane season is Jul–Nov.	La temporada de huracanes es de julio a noviembre.
High altitudes are cold, lowlands are warmer.	El tiempo es frío en las zonas altas de montaña, y más cálido en las tierras bajas.
Rainy season is Nov–Apr.	La estación lluviosa va de noviembre a abril.
In the subtropical south, Mar–Nov is dry season and Dec–Feb is wet season.	En el sur, donde el clima es subtropical, la estación seca va de marzo a noviembre y la lluviosa, de diciembre a febrero.
Belize has a humid subtropical climate.	Belice tiene un clima subtropical húmedo.
Bhutan ranges from subtropical in the south to cold in the mountainous north.	El clima de Bután varía de subtropical en el sur, a frío en las zonas alpinas del norte.
Hurricane season is Jun–Oct, but serious tropical storms are rare.	La temporada de huracanes es de junio a octubre, pero no suele haber tormentas tropicales fuertes.
Jun–Aug and Dec are peak travel time.	La temporada alta es de junio a agosto, y en diciembre.
Jun–Oct is cooler and drier.	Los meses de junio a octubre son más frescos y secos.
Jun–Sep is cool.	Los meses de junio a septiembre son frescos.
Margaret River has a Mediterranean climate.	Margaret River tiene un clima mediterráneo.
The weather is hot and rainy Nov–Mar, with thunderstorms and occasional hail.	De noviembre a marzo, el tiempo es caluroso y lluvioso, con tormentas y granizo ocasional.
Nov–Mar is often hot and rainy with occasional thunderstorms.	De noviembre a marzo, el tiempo es caluroso y lluvioso, con tormentas ocasionales.
However, tropical cyclones are possible Jan–Mar.	Sin embargo, hay probabilidad de ciclones tropicales entre enero y marzo.
The wet monsoon season is Nov–Apr.	La estación del monzón es de noviembre a abril.
Rainy season is Nov–May, with tropical cyclones possible Jan–Mar.	La estación lluviosa es de noviembre a mayo, y puede ir acompañada de ciclones tropicales entre enero y marzo.
The Gold Coast is famed for year-round sunshine and warm weather.	La Gold Coast es conocida por sus días calurosos y soleados todo el año.
The climate is temperate but quite variable.	El clima es templado, pero el tiempo varía bastante.
The climate is warm and dry May–Sep, peak time for visitors.	El tiempo es cálido y seco de mayo a septiembre, época que coincide con la temporada alta.
After you have removed unwanted programs from your computer, reset your browser settings.	Una vez que hayas eliminado los programas no deseados de tu ordenador, restablece la configuración del navegador.
At the bottom of your Mac computer, open Finder.	En la parte inferior de tu ordenador, abre el Finder.
You have to remove these programs before you can get your settings back to normal.	Para poder restablecer tu configuración habitual, tienes que eliminar estos programas.
Pop-up ads that won’t go away	Anuncios emergentes que no hay manera de quitar
Here are some common programs that are known to change your search settings.	Estos son algunos de los programas que suelen cambiar tu configuración de búsqueda:
More sellers and prices	Más vendedores y precios
Watch this video to learn more.	Para obtener más información, reproduce este vídeo .
Use your camera to record and share your own	Usa tu cámara para crearlos y compartirlos
Is your website correct?	¿El sitio web es correcto?
Is your address correct?	¿La dirección es correcta?
Are your hours correct?	¿El horario es correcto?
Starting grid will be available soon	La parrilla de salida estará disponible en breve
By having unprotected vaginal, anal, or oral sex.	Por sexo vaginal, anal u oral sin protección.
By animal or insect bites or stings.	Por la picadura de un insecto o la mordedura de un animal.
Light breeze from northwest	Vientos flojos del noroeste
Gale-force wind from north	Vientos del norte fuertes
Light air from south	Vientos del sur en calma
Light air from southeast	Vientos del sureste en calma
Light breeze from southwest	Vientos flojos del suroeste
Gale-force wind from northeast	Vientos del noreste fuertes
Gale-force wind from south	Vientos del sur fuertes
Fresh breeze from northwest	Vientos frescos del noroeste
Gale-force wind from southwest	Vientos del suroeste fuertes
Light air from northeast	Viente del noreste en calma
Fresh breeze from southwest	Vientos frescos del suroeste
Fresh breeze from north	Vientos frescos del norte
Light breeze from south	Vientos flojos del sur
Fresh breeze from south	Vientos flojos del sur
Light breeze from southeast	Vientos flojos del sureste
Fresh breeze from northeast	Vientos frescos del noreste
Fresh breeze from southeast	Vientos frescos del sureste
Light air from northwest	Vientos del noroeste en calma
Light breeze from north	Vientos flojos del norte
Gale-force wind from northwest	Vientos del noroeste fuertes
Gale-force wind from southeast	Vientos del sureste fuertes
In Remembrance of His Majesty King Bhumibol Adulyadej	En recuerdo de su majestad el rey Bhumibol Adulyadej
Light breeze from northeast	Vientos flojos del noreste
Light air from north	Vientos del norte en calma
Light air from southwest	Vientos del suroeste en calma
Some types preventable by vaccine	Algunos tipos son prevenibles con vacuna
Here’s how to find items you’ve saved from Google search results.	A continuación, te indicamos cómo encontrar los elementos que hayas guardado de entre los resultados de búsqueda de Google.
See or remove your saved items	Ver o retirar elementos guardados
Here’s how to save items:	A continuación, te indicamos cómo guardar elementos:
What you can save depends on how you use Google.	Los elementos que puedes guardar dependen de cómo uses Google.
On your iPhone and iPad, you can save images, places, and itineraries.	En el iPhone o iPad, puedes guardar imágenes, sitios e itinerarios.
Use Gboard with one hand!	Utiliza Gboard con una mano
Can't find what you are looking for?	¿No has encontrado lo que buscas?
Tap a description to suggest whether it applies to this place	Ayuda a describir el lugar tocando las características correspondientes
Choose how to describe this place	Elige cómo describir este lugar
To turn this feature on or off:	Para activar o desactivar esta función:
Tap to copy and send	Toca para copiar y enviar
Sign in to save jobs that interest you	Inicia sesión para guardar las ofertas de trabajo que te interesan
Account, privacy, and search	Cuenta, privacidad y búsqueda
Facts and quick answers	Información y respuestas rápidas
Calendar, alarms, reminders and information	Calendario, alarmas, recordatorios e información
Repeat a few times.	Repite este proceso varias veces.
Say or type the voice action.	Di o escribe la acción de voz.
Google learns some of your preferred apps	Google recuerda algunas de tus aplicaciones preferidas
Follow the steps below for what you want to do.	Sigue los pasos que se indican a continuación según lo que quieras hacer.
You’ll see information you can use to cite the book.	Encontrarás datos que puedes usar para citar el libro.
You can download some books and magazines for free to read later or print.	Puedes descargar algunos libros y revistas de forma gratuita para leerlos más tarde o imprimirlos.
Download, cite, or translate a book	Descargar, citar o traducir un libro
To what email address should this link?	¿Con qué dirección de correo electrónico se debe vincular?
Is this listing spam?	¿Esta ficha es spam?
A user reported that your listing is a duplicate	Un usuario nos ha informado de que tu ficha está duplicada
A user marked your business as spam	Un usuario ha marcado tu empresa como spam
A user reported that your business moved	Un usuario nos ha informado de que tu empresa se ha trasladado
Is this your new phone number?	¿Este es tu nuevo número de teléfono?
Is this your new website?	¿Este es tu nuevo sitio web?
Is this your new address?	¿Esta es tu nueva dirección?
Vladimir Dal’s 216th Birthday	216.º aniversario del nacimiento de Vladimir Dal
Valdemar Poulsen’s 148th Birthday	148.º aniversario del nacimiento de Valdemar Poulsen
Sitara Devi’s 97th birthday	97.º aniversario del nacimiento de Sitara Devi
Sor Juana Inés de la Cruz’s 366th birthday	366.º aniversario del nacimiento de sor Juana Inés de la Cruz
Rachel de Queiroz’s 107th Birthday	107.º aniversario del nacimiento de Rachel de Queiroz
Nellie Campobello’s 117th birthday	117.º aniversario del nacimiento de Nellie Campobello
Nain Singh Rawat’s 187th birthday	187.º aniversario del nacimiento de Nain Singh Rawat
Pedro Infante’s 100th Birthday	100.º aniversario del nacimiento de Pedro Infante
Meret Oppenheim’s 104th birthday	104.º aniversario del nacimiento de Meret Oppenheim
Françoise Dolto’s 109th Birthday	109.º aniversario del nacimiento de Françoise Dolto
Lachhu Maharaj’s 110th birthday	110.º aniversario del nacimiento de Lachhu Maharaj
José Clemente Orozco’s 134th birthday	134.º aniversario del nacimiento de José Clemente Orozco
Gertrude Jekyll’s 174th birthday	174.º aniversario del nacimiento de Gertrude Jekyll
Chinua Achebe’s 87th Birthday	87.º aniversario del nacimiento de Chinua Achebe
Cornelia Sorabji’s 151st birthday	151.º aniversario del nacimiento de Cornelia Sorabji
131st Anniversary of the Hole Puncher	131.º aniversario de la perforadora
You can delete categories that you created.	Puedes eliminar las categorías que hayas creado.
On the left, click a category.	En la izquierda, haz clic en una categoría.
Choose a category you want to delete.	Elige la categoría que quieras eliminar.
Share books in your library	Compartir libros de tu colección
You can collect books and magazines in a personal library on Google Books.	Puedes recopilar libros y revistas en una colección personal en Google Libros.
Choose the category where the book is.	Elige la categoría donde está el libro.
Remove books from your library	Quitar libros de tu colección
Add books to your library	Añadir libros a tu colección
Enter the ISBNs or ISSNs of the books or magazines you want to add.	Introduce los ISBN o ISSN de los libros o las revistas que quieras añadir.
Add, organize, or share books	Añadir, organizar o compartir libros
Monitor the web for interesting new content	Supervisa la Web para encontrar nuevos contenidos interesantes
Monitor the Web for interesting new content	Busca contenido nuevo e interesante en la Web
Google Alerts - Monitor the Web for interesting new content	Alertas de Google: controla la Web en busca de nuevo e interesante contenido
How can we help you?	¿En qué podemos ayudarte?
Copy or share a link, re-open a link in your browser, and more	Copiar o compartir un enlace, volver a abrir un enlace en el navegador y mucho más.
Signed-out search activity is off	La actividad de búsqueda sin sesión iniciada está desactivada
Signed-out search activity is on	La actividad de búsqueda sin sesión iniciada está activada
View and manage your cloud messaging configurations	Ver y administrar las configuraciones de mensajería de la nube
We’ll analyze your feedback but we don’t automatically remove reported predictions.	Analizaremos los comentarios, pero no retiraremos automáticamente las predicciones de las que se nos informe.
Other than Trending stories, you can’t turn off search predictions.	Las predicciones de búsqueda no se pueden desactivar, excepto las de temas populares.
You can always choose not to use search predictions.	Siempre puedes optar por no usar las predicciones de búsqueda.
Note: Search predictions aren’t the answer to your search.	Nota: Las predicciones de búsqueda no son la respuesta a tu búsqueda
When you choose a prediction, you do a search using the term you selected.	Si seleccionas una predicción, se realizará una búsqueda con el término seleccionado.
The terms you’re typing.	Los términos que estás escribiendo en ese momento
More parties and leaders	Más partidos y líderes
View and manage partner device information on Android Partner Front-End	Ver y administrar información sobre dispositivos de partners en Android Partner Front-End.
Please enter a valid email address.	Introduce una dirección de correo electrónico válida.
More about this show	Más información sobre este programa
From your Google Account	De tu cuenta de Google
More world market news	Más noticias del mercado internacional
Make it easier for customers to order for pickup or delivery	Facilita a tus clientes los pedidos con recogida o entrega
Let customers make reservations directly	Permite a tus clientes reservar de forma directa
Have a link for online orders?	¿Tienes un enlace para pedidos online?
Have a link for online reservations?	¿Tienes un enlace para reservas online?
Done with this card	No quiero ver esta tarjeta
If that doesn’t work, try restarting your phone.	Si esto no funciona, prueba a reiniciar el teléfono.
Type in multiple languages	Escribir en varios idiomas
Send emojis, GIFs, and stickers	Enviar emojis, GIFs y pegatinas
Search and send emojis and GIFs	Buscar y enviar emojis y GIFs
Make Gboard your main keyboard	Hacer que Gboard sea el teclado principal
More destinations on Google Flights	Más destinos en Google Flights
Gboard switches to another keyboard	Gboard cambia a otro teclado
A title and link to the page will be entered in the message field.	Se incluirán un título y un enlace a la página en el campo del mensaje.
In the Search bar, start typing search terms.	En la barra de búsqueda, empieza a escribir los términos de búsqueda.
Then, you can share your search result cards.	A continuación, puedes compartir las tarjetas de resultados de tus búsquedas.
You can search for things like a flight number or videos.	Puedes buscar cosas como un número de vuelo o vídeos.
With Gboard, you can search as you normally would with Google.	Con Gboard, puedes realizar búsquedas tal y como lo harías normalmente con Google.
While in an app, tap the message field.	Abre una aplicación y toca el campo del mensaje.
Download and set up Gboard	Descargar y configurar Gboard
Share your thoughts and where you are	Comparte lo que piensas y dónde estás
Allow Gboard to access your contacts to enable contact sharing.	Permite que Gboard acceda a tus contactos y habilite los contactos compartidos.
You can change this in Gboard settings.	Puedes cambiar esta opción en la configuración de Gboard.
Reviewed claims by this publisher	Reclamaciones revisadas de este editor
Send a message to this business. This business typically responds in a few weeks.	Envía un mensaje a esta empresa. Suelen responder en pocas semanas.
Send a message to this business. This business typically responds in a day.	Envía un mensaje a esta empresa. Suelen responder en un día.
Send a message to this business. This business typically responds in a few days.	Envía un mensaje a esta empresa. Suelen responder en pocos días.
Send a message to this business. This business typically responds in a few hours.	Envía un mensaje a esta empresa. Suelen responder en pocas horas.
Send a message to this business. This business typically responds in a few minutes.	Envía un mensaje a esta empresa. Suelen responder en pocos minutos.
Past browsing and download history may be stored in your browser’s cache.	Los historiales de navegación y de descargas se pueden almacenar en la caché de tu navegador.
To remove these results, follow these steps:	Para quitar estos resultados, haz lo siguiente:
Look in the top right corner of the page.	Observa la esquina superior derecha de la página.
Follow these steps to check if you’re signed out of your browser:	Para comprobar si has cerrado sesión en el navegador, sigue estos pasos:
Remove all custom results	Quitar todos los resultados personalizados
Sign out of your Google Account	Cerrar la sesión de tu cuenta de Google
Open private browsing mode	Abrir el modo de navegación privada
Search privately on a mobile browser	Hacer búsquedas de forma privada en un navegador para móviles
You may need to enter your Google account password when changing these settings.	Es posible que debas introducir la contraseña de tu cuenta de Google para poder modificar esta configuración.
Change your payment or delivery info	Cambiar los datos de pago o de entrega
Follow the steps to choose or enter your payment method and delivery address.	Sigue los pasos para elegir o introducir el método de pago y la dirección de entrega.
To search Google or GIFs, connect to Wi-Fi or a cellular network.	Para buscar algo en Google o elegir un GIF, conéctate a una red Wi‑Fi o móvil.
Open an app, then tap the message field.	Abre una aplicación y, a continuación, toca el campo del mensaje.
* Persian support has been added to the iPad	* Ahora se puede escribir en persa con el iPad.
Walks and hits per innings pitched	Bases por bolas y hits por entradas lanzadas
Violeta Parra’s 100th Birthday	Centenario del nacimiento de Violeta Parra
Wilhelm Bartelmann’s 172nd birthday	172 aniversario del nacimiento de Wilhelm Bartelmann
Bagong Kussudiardja’s 89th Birthday	89 aniversario del nacimiento de Bagong Kussudiardja
Begum Akhtar’s 103rd birthday	103 aniversario del nacimiento de Begum Akhtar
Fridtjof Nansen’s 156th Birthday	156 aniversario del nacimiento de Fridtjof Nansen
Clare Hollingworth’s 106th birthday	106 aniversario del nacimiento de Clare Hollingworth
Click to view place information	Haz clic para ver información sobre este sitio
pic,pics,picture,pictures,image,images	foto, fotos, fotografía, fotografías, imagen, imágenes
Follow the steps to record your voice.	Sigue los pasos para grabar tu voz.
Give us a call for more information.	Llámanos para obtener más información.
Save places and Google will create custom itineraries, just for you.	Guarda sitios para que Google te cree itinerarios personalizados.
Speak like you would to a person	Habla como lo harías si tu interlocutor fuera una persona.
On iPhones, podcasts aren’t available yet.	Los podcasts todavía no están disponibles en los iPhones.
Add, change, or delete an address.	Añade, cambia o elimina una dirección.
Add, change, or delete a location	Añadir, cambiar o eliminar una ubicación
What you can get info about	Tipos de información que puedes obtener
Buy items on your list	Comprar productos de tu lista
Change or remove items	Cambiar o quitar productos
To remove an item, tap the box.	Para quitar un producto, toca la casilla correspondiente.
Take a close-up photo that clearly shows the hours for Google to scan	Haz una foto donde se muestre claramente el horario en primer plano para que Google pueda escanearla
Make your changes and tap outside the nickname box.	Realiza los cambios que quieras y toca fuera del cuadro del apodo.
Rename or delete a list	Cambiar el nombre de una lista o eliminarla
You can share a list with as many people as you want.	Puedes compartir una lista con tantas personas como quieras.
See or change your primary list	Ver o modificar tu lista principal
You can change your primary list whenever you want.	Puedes modificar esta lista siempre que quieras.
If you don’t want to use your voice, you can add items to a list manually.	Si no quieres utilizar la voz, puedes añadir productos a una lista de forma manual.
Items are automatically added to your primary shopping list.	Los productos se añaden automáticamente a tu lista de la compra principal.
Say what you want to add to your list, for example:	Di qué quieres añadir a la lista. Por ejemplo:
Longest field goal made	Gol de campo mas largo anotado
Enter your work address	Escribe la dirección del trabajo
Access weather instantly from your Home screen	Accede al tiempo en un instante desde la pantalla de inicio
Designed to show the range of information on the web.	Está diseñado para mostrar cualquier tipo de información disponible en la Web.
So that we can help you, please make sure that your request meets these requirements:	Para que podamos ayudarte, asegúrate de que tu solicitud cumpla los siguientes requisitos:
We only remove image or videos in which you personally appear that meet our requirements.	Solo retiraremos las imágenes o los vídeos en los que aparezcas personalmente y que cumplan nuestros requisitos.
Search for contacts to share phone numbers and emails.	Busca contactos para compartir números de teléfono y correos electrónicos.
Help improve this result for English	Ayudar a mejorar la traducción al español de este resultado
Swipe left to see recently shared contacts.	Desliza a la izquierda para ver contactos compartidos hace poco.
Medium-term: resolves within months	Duración media: la recuperación suele durar varios meses
Where search predictions come from	De dónde proceden las predicciones de búsqueda
What is shown in this picture?	¿Qué aparece en la imagen?
Play Word Coach to learn more about words you looked up	Juega a Word Coach para obtener más información sobre las palabras que has buscado
Learn new words and improve your English vocabulary	Aprende palabras nuevas y amplía tu vocabulario en inglés
Play Google Word Coach, a game that helps you learn new words	Juega a Google Word Coach, un juego que permite aprender palabras nuevas
No results found with filters applied.	No se ha encontrado ningún resultado al aplicar los filtros.
Trips are created from confirmations sent to your Gmail and details you have manually added.	Los viajes se crean a partir de las confirmaciones que recibes en tu bandeja de entrada de Gmail y los detalles que añades manualmente.
Search by store name	Buscar por nombre de la tienda
See delivery pricing and policy here.	Consulta los precios y la política de entrega aquí mismo.
New Doodle games, videos, and interactive experiences	Nuevos juegos, vídeos y experiencias interactivas de Doodles
Short-term: resolves within days to weeks	Duración breve: la recuperación suele durar varios días o semanas
Chronic: can last for years or be lifelong	Crónica: puede durar años o toda la vida
Manage your Ad Exchange buyer creatives	Administrar tus creatividades para compradores de Ad Exchange
You solved all the puzzles!	¡Has resuelto todos los jeroglíficos!
It seems that you solved all the puzzles!	Has resuelto todos los jeroglíficos
Just give me one	¿Me puedes dar una sola opción, porfa? ☺️
Your new home for saved items	Tu nuevo espacio para los elementos que guardas
Why am I seeing this?	¿Por qué aparece este mensaje?
What should I call you?	¿Cómo quieres que te llame?
Here are the top stories	Aquí tienes las principales noticias
Here are the latest headlines	Estos son los últimos titulares
When do you want to be reminded?	¿Cuándo quieres recibir el recordatorio?
Safe extensions that you already have on your computer are sometimes purchased by hackers.	En ocasiones, los piratas informáticos compran las extensiones seguras que tienes en tu ordenador.
To prevent this, always read through the update notification carefully.	Lee detenidamente las notificaciones de actualización para evitar que esto ocurra.
Sometimes you download a program you want, but the program also contains bad software.	En ocasiones descargas un programa que también incluye software dañino.
Right-click the name of any unwanted programs.	Haz clic con el botón derecho en el nombre de los programas no deseados.
A redirect to an unfamiliar web page	Un redireccionamiento a una página web que no te resulta familiar
A search engine that looks like Google, but with the wrong logo or web address	Un motor de búsqueda que se parece a Google en el que se muestra una dirección web o un logotipo incorrectos
Start typing for suggestions	Empieza a escribir para ver sugerencias
Tell customers about special events, promotions, or products	Informa a los clientes sobre eventos especiales, promociones o productos
Have news to share with your customers?	¿Tienes noticias que compartir con tus clientes?
Sign in to see places you visited.	Inicia sesión para ver los sitios que has visitado.
One of the most viewed hotels in this area this week	Uno de los hoteles más vistos de esta zona esta semana
New results match your search on Google	Hay nuevos resultados que coinciden con tu búsqueda en Google
Go to Google My Business	Ir a Google My Business
Find answers in reviews...	Buscar respuestas en las reseñas...
Ready to do more for your business on Google?	¿Estás listo para sacarle más partido a tu negocio en Google?
New! Follow topics that interest you	¡Nuevo! Sigue los temas que te interesen
Turn your feed on or off	Activar o desactivar el feed
Change your language on Google	Cambiar el idioma en Google
Tap a type of card to see options and make changes.	Toca un tipo de tarjeta para ver sus opciones y realizar los cambios pertinentes.
Confirm your choice if asked.	Confirma tu elección si se te pide hacerlo.
You can turn certain account settings on or off to control which data is stored.	Puedes activar o desactivar ciertas opciones de configuración de la cuenta para controlar qué datos se almacenan.
Control what information Google can use	Controlar qué información puede utilizar Google
Choose if you want cards in your feed and notifications.	Indica si quieres ver tarjetas en tu Tablón y tus notificaciones.
Choose which apps and websites show cards.	Elige qué aplicaciones y sitios web quieres que muestren tarjetas.
How Google decides what shows up in your feed	Cómo determina Google lo que se muestra en el Tablón
Choose what shows up in your feed	Elegir lo que se muestra en el Tablón
Turn categories on or off.	Activar o desactivar categorías.
Choose the types of cards you want to see in your feed	Elige los tipos de tarjeta que quieres ver en el Tablón
44th Anniversary of the Birth of Hip Hop	44.º aniversario del nacimiento del hip hop
Free on Google Play	Gratis en Google Play
Comments will be open shortly before the match	Los comentarios estarán disponibles poco antes del partido
Is this place popular with the college crowd?	¿Es un lugar popular entre los estudiantes?
What Wi-Fi service is here?	¿Qué servicio de Wi-Fi tienen en este sitio?
Does this place sell women's clothing?	¿Se vende ropa de mujer en este lugar?
Double Pinyin - Pinyin PlusPlus	Doble pinyin: Pinyin PlusPlus
View your Firebase Analytics data	Ver tus datos de Firebase Analytics
Let customers open your menu directly	Haz que los clientes puedan abrir el menú directamente
Have a link to your menu?	¿Tienes un enlace a tu menú?
Improve your online presence by linking to your official website	Mejora tu presencia online con un enlace a tu sitio web oficial
Listings with photos draw more clicks than those without	Las fichas con fotos suelen tener más clics que las que no muestran ninguna
Google sign-in prompt	solicitud de inicio de sesión de Google
These words are saved only to your device.	Estas palabras solo se guardan en tu dispositivo
What Gboard sends to Google	Lo que Gboard envía a Google
You can tap the translated text to see more translations.	Puedes tocar el texto traducido para ver más traducciones.
Tap the language to translate from.	Toca el idioma de origen.
Send emojis and GIFs	Enviar emojis y GIFs
To type in multiple languages, select an option below to choose languages.	Para escribir en varios idiomas, selecciónalos siguiendo una de las opciones que se muestran a continuación.
Use multiple languages in the same conversation.	Utilizar varios idiomas en la misma conversación.
On some Android devices, Gboard is already the default keyboard.	En algunos dispositivos Android, Gboard ya es el teclado predeterminado.
A word will be entered in the message field.	Se introducirá una palabra en el campo del mensaje.
Choose which apps and websites show cards in your feed.	Elige qué aplicaciones y sitios web muestran tarjetas en tu feed.
Choose what shows up in your feed	Elegir lo que se muestra en tu feed
At the top left, tap your profile image.	En la parte superior izquierda, toca tu imagen de perfil.
Tip: Location can be changed in the search box	Consejo: Si quieres cambiar la ubicación, escribe una en el cuadro de búsqueda
Show jobs nearby only	Mostrar solo los trabajos cercanos
Try removing some filters.	Prueba a retirar algunos filtros
Search tools can include things like location, color, size, and the date a page was published.	Las herramientas de búsqueda incluyen filtros como la ubicación, el color, el tamaño y la fecha en la que se publicó una página.
Sign in and click My Maps to see your starred places on any computer.	Accede a tu cuenta y haz clic en Mis mapas para ver tus sitios destacados desde cualquier equipo.
Choose if you want to open links to maps in Google Maps.	Elige si quieres que se abran enlaces a los mapas en Google Maps.
You might need to sign in to your Google Account.	Es posible que debas iniciar sesión en tu cuenta de Google.
Changes you might notice	Cambios que puedes notar
Click the title to go to the site.	Haz clic en el título para acceder al sitio web.
Make Google my homepage	Establecer Google como página principal
Click on one of the links below to learn about that part of the results page.	Haz clic en uno de los enlaces que se muestran a continuación para obtener información sobre esa parte concreta de la página de resultados.
View and manage your Google Play music library	Permite ver y gestionar tu colección de música de Google Play
Press the Google Assistant button.	Pulsa el botón Asistente de Google.
Get tips on how to talk to your Assistant, get notifications, and reply to messages	Recibe notificaciones, consejos sobre cómo hablar con el Asistente y responde a mensajes
Hear incoming notifications read aloud	Escucha las notificaciones entrantes en voz alta
Click on your picture to sign out or add a new Google Account.	Haz clic en tu imagen para cerrar sesión o añadir una nueva cuenta de Google.
Activate to close menu	Activar para cerrar el menú
Lists are where you add and organize your saved items.	Las listas te permiten añadir y organizar elementos guardados.
View list in Maps	Ver la lista en Maps
You need to hold the button while your are speaking and let go after you finish, please try again.	Tienes que mantener pulsado el botón mientras hablas y soltarlo cuando acabes. Inténtalo de nuevo.
To switch to the next station, double press the Google button.	Para cambiar a la siguiente emisora, pulsa dos veces el botón Google.
To hear more, press the Google Assistant button.	Para escuchar más, pulsa el botón Asistente de Google.
To hear your messages and updates, press the Google button.	Para escuchar mensajes y actualizaciones, mantén pulsado el botón Google.
To switch to the next station, long-press the right button.	Para cambiar a la siguiente emisora, mantén pulsado el botón derecho.
To hear more, hold the top button.	Para escuchar más, pulsa el botón de la parte superior.
To start, go to Bluetooth Settings and connect to your device.	Para empezar, ve a los ajustes de Bluetooth y conecta tu dispositivo.
To hear your messages and updates, press and hold the top button.	Para escuchar mensajes y actualizaciones, mantén pulsado el botón de la parte superior.
Tap to connect your Bisto device.	Toca para conectar tu dispositivo de Bisto.
Marking reminder as done	Marcando el recordatorio como completado
Click your name to go to your Google+ page.	Haz clic en tu nombre para acceder a tu página de Google+.
You solved all the riddles!	¡Has resuelto todos los acertijos!
It seems that you solved all the riddles!	Veo que has resuelto todos los acertijos
Search for pictures with Google Goggles	Buscar imágenes con Google Goggles
Choose talk or type as your default	Hablar o escribir: configurar la opción predeterminada
Do a search on Google.	Haz una búsqueda en Google.
Images still aren’t appearing	Las imágenes siguen sin aparecer
To give feedback or report a suggestion, just swipe left on it.	Para enviarnos un comentario sobre una sugerencia autocompletada, o si crees que debes denunciarla, toca la sugerencia en cuestión y desliza el dedo hacia la izquierda.
Ask a question or say a command.	Haz una pregunta o di un comando.
See if you have Google Play services	Comprobar que tengas los Servicios de Google Play
See if your phone has the requirements	Comprobar que el teléfono cumpla los requisitos
Meet your Google Assistant	Te presentamos a tu Asistente de Google
Susan La Flesche Picotte’s 152nd Birthday	152 aniversario del nacimiento de Susan La Flesche Picotte
Tayeb Salih’s 88th Birthday	88 aniversario del nacimiento de Tayeb Salih
Machado de Assis’ 178th Birthday	178 aniversario del nacimiento de Machado de Assis
Marshall McLuhan’s 106th Birthday	106 aniversario del nacimiento de Marshall McLuhan
Tina Modotti’s 121st Birthday	121 aniversario del nacimiento de Tina Modotti
Luang Pradit Phairoh’s 136th Birthday	136 aniversario del nacimiento de Luang Pradit Phairoh
James Wong Howe’s 118th Birthday	118 aniversario del nacimiento de James Wong Howe
Gilberto Bosques’ 125th Birthday	125 aniversario del nacimiento de Gilberto Bosques
Visit Google My Business	Visitar Google My Business
This trip may have changed recently. Please reload your browser.	Este viaje puede haber cambiado hace poco. Vuelve a cargar el navegador.
View and manage your forms, data-collection efforts, and settings	Consulta y administra tus formularios, tus documentos de recogida de datos y tu configuración.
Delete a specific activity	Eliminar una actividad en concreto
View usage reports for users on your domain	Consulte informes de uso de los usuarios de su dominio.
You can call us, chat with us online, or send feedback.	Puedes llamarnos, chatear con nosotros online o enviarnos comentarios.
Contact us or send feedback	Contactar con nosotros o enviar comentarios
Follow the steps to add your account.	Sigue las instrucciones para añadirla.
Following in your feed	Siguiendo en Mi tablón
I didn't catch that.	No te he entendido.
Here are your results.	Estos son los resultados.
Sorry, I don't understand.	Lo siento, pero no te entiendo.
Google Home companion screen	Pantalla complementaria de Google Home
Get local information and the latest updates	Obtén información local y las noticias más recientes
Gboard now supports Arabic, Persian, and Hebrew!	Ahora Gboard está disponible en árabe, persa y hebreo.
Noor Jehan’s 91st Birthday	91.º aniversario del nacimiento de Noor Jehan
Sir John Cornforth’s 100th Birthday	100.º aniversario del nacimiento de Sir John Cornforth
Samuel Johnson’s 308th Birthday	308.º aniversario del nacimiento de Samuel Johnson
Grazia Deledda’s 146th Birthday	146.º aniversario del nacimiento de Grazia Deledda
Gilberto Bosques Saldívar’s 125th Birthday	125.º aniversario del nacimiento de Gilberto Bosques Saldívar
55th Anniversary of Khao Yai National Park	55.º aniversario del Parque Nacional Khao Yai
Offers for this business	Ofertas de esta empresa
Own this business? Get more customers	¿Eres el propietario de esta empresa? Consigue más clientes
Own this business? Manage it now	¿Eres el propietario de esta empresa? Gestiónala ahora
How can we improve your experience?	¿Cómo podemos mejorar tu experiencia?
Tips for attention-grabbing posts.	Consejos para crear publicaciones atractivas
Our top three tips for posting on Search	Tres consejos básicos para publicar en la Búsqueda
Learn how to create posts that get noticed.	Obtén información sobre cómo crear publicaciones atractivas.
Here are some flights for your trip	Aquí tienes algunas opciones de vuelos para tu viaje
Email failed to send. Please try again later.	No se ha podido enviar el correo electrónico. Inténtalo de nuevo más tarde.
Sorry, which did you want to resume?	Disculpa, ¿cuál quieres que reactive?
See the details on your phone.	Consulta los detalles en el teléfono.
Sorry, which did you want to reset?	Perdona, ¿cuál es el que quieres restablecer?
With light traffic, it will take one hour and fifty-nine minutes to get to Eiffel Tower from your home by bike.	Con poco tráfico, se tarda una hora y cincuenta y nueve minutos en llegar en bici a la Torre Eiffel desde tu casa.
It takes one hour and fifty-nine minutes to drive from your home to Eiffel Tower.	Se tarda una hora y cincuenta y nueve minutos en llegar en coche desde tu casa a la Torre Eiffel.
Your home is sixteen point seven meters away from Eiffel Tower by bike.	Tu casa se encuentra a una distancia de dieciséis coma siete metros de la Torre Eiffel en bici.
It takes one hour and fifty-nine minutes to bike from your home to Eiffel Tower.	Se tarda una hora y cincuenta y nueve minutos en llegar en bici desde tu casa a la Torre Eiffel.
With light traffic, it will take one hour and fifty-nine minutes to get to Eiffel Tower from your home by car.	Con poco tráfico, se tarda una hora y cincuenta y nueve minutos en llegar en coche a la Torre Eiffel desde tu casa.
Your home is sixteen point seven meters away from Eiffel Tower by car.	Tu casa se encuentra a una distancia de dieciséis coma siete metros de la Torre Eiffel en coche.
Sorry, what do you want to add?	Perdona, ¿qué querías añadir?
The Warriors are batting.The Spurs are bowling.	Los Warriors batean; los Spurs lanzan.
The Pirates are batting.The Spurs are bowling.	Los Pirates batean; los Spurs lanzan.
The Golden State Warriors and the San Antonio Spurs are tied for first in the Western Conference.	Los Golden State Warriors y los San Antonio Spurs están empatados en primer lugar en la Conferencia Oeste.
Choose how you want to talk with us.	Elije cómo quieres que nos comuniquemos.
Meet your Google Assistant.	Te presentamos a tu Asistente de Google.
To use that button, connect to a mobile or Wi-Fi network.	Para utilizar ese botón, conéctate a una red Wi‑Fi o móvil.
Is your web page mobile friendly?	¿Tu página web está optimizada para móviles?
Syed Sadequain Ahmed Naqvi’s 87th Birthday	87 aniversario del nacimiento de Syed Sadequain Ahmed Naqvi
Stop sharing this list? The link will stop working for anyone you shared it with.	¿Quieres dejar de compartir esta lista? El enlace dejará de funcionar para todas las personas con las que la hayas compartido.
Only you can see this list	Solo tú puedes ver esta lista
Anyone with the link can see this list	Cualquier usuario con el enlace puede ver esta lista
Edit in Google Trips	Editar en Google Trips
Delete trip from Google	Eliminar viaje de Google
Toggle between front and back cameras	Alternar la cámara frontal y la trasera
Organization to contact: Foundation for Social Welfare Services	Organización de contacto: Foundation for Social Welfare Services
You can always add a few descriptive words if necessary.	Si el resultado no es el que esperabas, siempre puedes añadir algunas palabras descriptivas más.
Check out the links below to learn more advanced search techniques.	consulta los enlaces que te ofrecemos a continuación para conocer técnicas de búsqueda más avanzadas.
This helps people searching online know they’re seeing up-to-date content.	De este modo, los usuarios que realizan búsquedas online saben que consultan contenido actualizado.
Publish a new update to share your news with people online.	Publica otra novedad que quieras compartir con los usuarios online.
Your last post on Google Search will expire tomorrow	Tu última publicación en la Búsqueda de Google dejará de mostrarse mañana
A recent post has been removed.	Se ha retirado una de tus publicaciones
Posts last in search results for seven days by default.	De forma predeterminada, las publicaciones permanecen siete días en los resultados de búsqueda.
How far away is the moon?	¿A qué distancia está la Luna?
Choose what you want to share with people searching for you online.	Elige qué quieres compartir con las personas que te buscan online.
Ready for your first post?	¿Todo listo para crear tu primera publicación?
Create your first post in search results	Crea tu primera publicación en los resultados de búsqueda
Publish updates to people looking for you online.	Publica contenido nuevo para las personas que te buscan online.
Have questions or want to share your experience?	¿Tienes preguntas o quieres compartir tu experiencia?
Try adding links to your posts.	Prueba a añadir enlaces a tus publicaciones.
What worked well for others using this feature on Search	Qué les ha funcionado a otras personas que han usado este recurso en la Búsqueda
Number of times your posts were seen this week	Número de veces que los usuarios han visto tus publicaciones esta semana
Already including images in your posts?	Si tus publicaciones ya incluyen imágenes,
Number of posts created this week	Número de publicaciones que has creado esta semana
Learn how your posts performed on Google Search.	Descubre el rendimiento de tus publicaciones en la Búsqueda de Google.
You might see a preview or the entire book or magazine.	Es posible que obtengas solo un avance o el libro o la revista en su totalidad.
To turn on notifications on your iPhone or iPad:	Para activar las notificaciones en tu iPhone o iPad:
Try the full My Activity.	Prueba la versión completa de Mi Actividad.
Find and manage other data associated with your account in My Activity.	Busca y administra otros datos asociados a tu cuenta en Mi Actividad.
I need access to notifications and location to complete this action	Necesito acceder a las notificaciones y la ubicación para realizar esta acción
I need access to location to complete this action	Necesito acceder a la ubicación para realizar esta acción
I need notifications enabled to complete this action	Necesito que las notificaciones estén habilitadas para realizar esta acción
The information you get may be different from what people closer to the crisis area see.	Puede ser que la información que veas sea distinta a la que ven otras personas que se encuentren más cerca de la zona de crisis.
Check back again for updates as the crisis evolves.	Vuelve a comprobar si hay novedades mientras la crisis evoluciona.
Your search query may be too broad.	Puede que tu consulta de búsqueda sea demasiado amplia.
Try searching for keywords that include both the type of disaster and the name of the affected area.	Prueba a buscar palabras clave que incluyan tanto el tipo de desastre como el nombre de la zona afectada.
Nude or sexually explicit images that were uploaded or shared without your consent	Imágenes sexualmente explícitas o de desnudos subidas o compartidas sin tu consentimiento
Is it confidential, or is it publicly available information?	¿Es información privada, o de dominio público?
Is it a government-issued identification number?	¿Es un número de identificación emitido por organismos públicos?
How we decide if personal information should be removed	Cómo decidimos si retirar la información personal
Your insights help people find the best places to go	Tus comentarios ayudan a los usuarios a encontrar los mejores sitios
Your question was posted to the community	Tu pregunta se ha publicado en la comunidad
We’d appreciate your input.	Tu opinión nos puede ser de mucha ayuda.
Receive notifications from all your apps on these headphones	Recibe notificaciones de todas tus aplicaciones en estos auriculares
Get notifications from these apps	Recibe notificaciones de estas aplicaciones
New features and fixes are available. This update may take a few minutes.	Nuevas funciones y correcciones de errores disponibles. La actualización podría durar unos minutos.
Double tap to manage your person info settings.	Toca dos veces para administrar los ajustes de información personal.
Your headphones are ready to use	Los auriculares ya se pueden usar
Double tap to manage your payment settings.	Toca dos veces para administrar los ajustes de los pagos.
Double tap to manage your shared devices settings.	Toca dos veces para administrar los ajustes de los dispositivos compartidos.
See or remove your saved images	Ver o retirar las imágenes guardadas
To include images, add an image for each option.	Si quieres incluir imágenes, debes añadir una para cada opción.
What weather temperature units do you prefer?	¿Qué unidad prefieres para la temperatura ambiente?
Add new credit or debit card	Añadir tarjeta de crédito o débito
Move devices here to other rooms before you delete this room.	Mueve los dispositivos a otras salas antes de eliminar esta.
Use your Assistant to control music and video on the following devices:	Usa el Asistente para controlar la música y el vídeo en los dispositivos siguientes:
Drag to change the order in your narrated news.	Arrastra los elementos para cambiar su orden en las noticias narradas.
Trouble creating the post. Refresh the page and try again.	Se ha producido un error al crear la publicación. Actualiza la página e inténtalo de nuevo.
Could not retrieve topic. Refresh the page.	No se ha podido recuperar el tema. Actualiza la página.
Deleting this post will permanently remove it from your account	Si eliminas esta entrada, se quitará permanentemente de tu cuenta.
Post often and add photos and videos to make your posts more effective	Publica con frecuencia y añade fotos y vídeos para obtener mejores resultados
Your default time zone has been updated.	Se ha actualizado la zona horaria predeterminada.
Your post is live on Google	Tu publicación aparece en Google
Failed to update default time zone. Please try again	Se ha producido un error al actualizar la zona horaria predeterminada. Inténtalo de nuevo.
Welcome! Create your first post.	Te damos la bienvenida. Crea tu primera publicación.
The scheduling information you provided is invalid. Update it and try again.	La información de programación que has proporcionado no es válida. Actualízala e inténtalo de nuevo.
Failed to delete post. Try again.	Se ha producido un error al eliminar la entrada. Inténtalo de nuevo.
You need text or at least one image or video.	Necesitas texto o como mínimo una imagen o un vídeo.
Your user settings could not be found.	No se ha encontrado la configuración de usuario.
The visibility information you provided is invalid. Update it and try again.	La información de visibilidad que has proporcionado no es válida. Actualízala e inténtalo de nuevo.
Change your language for this Google Home device	Cambia el idioma de este dispositivo Google Home
Your calls will now use an unlisted number	Ahora puedes usar un número oculto para tus llamadas
Reminder needs a valid location.	El recordatorio necesita una ubicación válida.
Sorry, when is the event?	Perdona, ¿cuándo es el evento?
Sorry, which did you want to cancel?	Perdona, ¿cuál querías cancelar?
See and delete your saved items	Ver y eliminar elementos guardados
See and delete your saved images	Ver y eliminar las imágenes guardadas
Go to Google.com and do a search.	Ve a Google.com y realiza una búsqueda.
When you search on Google from your computer, you can save images to lists.	Cuando realizas búsquedas en Google desde tu ordenador, puedes guardar imágenes en listas.
The Warriors finished with a zero and one record this season.	Esta temporada, los Warriors terminaron con cero victorias y una derrota.
The Pirates finished with a zero and one record this season.	Esta temporada, los Pirates terminaron con cero victorias y una derrota.
Configure devices for access to Wi-Fi networks	Permite configurar dispositivos para acceder a redes Wi-Fi
Search for Google Cast devices on your wifi network...	Buscando dispositivos Google Cast en tu red Wi-Fi…
Your calls will now be anonymous	Ahora tus llamadas serán anónimas
Go to your browser to change the following settings:	Accede al tuyo para modificar las siguientes opciones de configuración:
Delete your browser history	Eliminar el historial del navegador.
Get help with other Google products	Obtener ayuda con otros productos de Google
Clear your cache and cookies	Borrar la memoria caché y las cookies.
Change your Android Google app settings	Cambiar la configuración de la aplicación de Google para Android
We apply this policy on a case-by-case basis.	Aplicamos esta política según las peculiaridades de cada caso.
Request to have personal information removed	Solicitar que retiremos información personal
Can it be used for common financial transactions?	¿Se puede utilizar para las transacciones financieras habituales?
Information we may remove	Información que podríamos retirar
Child sexual abuse imagery	Si el contenido incluye imágenes de abuso sexual infantil.
Warning: You will need to re-link your account soon.	Advertencia: Deberás volver a enlazar tu cuenta próximamente.
Error: Please re-link your account.	Error: Vuelve a enlazar tu cuenta.
Sorry, I’m not sure which device you’d like to control. Can you be more specific?	Perdona, no sé qué dispositivo quieres controlar. ¿Podrías concretar un poco más?
Please specify which mode you want to turn on.	Especifica qué modo quieres activar.
Sorry, Nest thermostats are limited to a set number of adjustments per hour.	Lo siento, los termostatos Nest están limitados a un número determinado de ajustes por hora.
